30 100
CTTTCCACTACCCGCACGGCATCAATCCCA|TGACCTTGCGATTGAATGAACAACGTCGCG
CCTGAACAGCCTGTACTGGCGTACTCAACT|CAAAGGCCCTCAATACTGGCGTACTCAAAG
TAGATTAGTGGCGTACTCAAAGGCCCTCAA|GTACTCAAAGGCCCTCAATATTAGATAACT
GATAATTTGACTAAGTCAGCAGTTTTCAGA|ACTTCCCACTCAGCCTGAACAGCCTGTACT
GAGACCAGACATCCGACTGGCGTACTCAAA|ACTGCTAAAGAAGCAATACGACCTTGGGTA
GACTTTCCACTACCCGCACGGCATCAATCC|ATTGACCTTGCGATTGAATGAACAACGTCG
GGTGGTATGGATATACATTCTTACCTGGTG|TACTCAAAGGCCCTCAATATTAGTCTCTTT
CAATATTAGTTACGGAATTTCCATGAGCGG|TCTATCGCATTTAAACTGGCGTACTCAAAG
TGTTTGTAATGCATAGGTGCCCTGGGAGCA|TTAGTCGTCGACGACCCTTGCTCGGTGGTA
GGTGCGGATTATACTGGCGTACTCAAAGGC|TAGCGTTGCAGAGTGCCATACAGAGTGTGT
ACTCAAAGGCCCTCAATATTAGCGTTGCAG|TCAATATTAGGCTTAGTTCATTGGGTCCGT
GTACTCAACTGGCGTACTCAAAGGCCCTCA|GTACTCAAAGGCCCTCAATATTAGATTAGT
AAAGGCCCTCAATATTAGATAACTTGCTGT|AGAGCTAGTTGGTGGCAAAACCCCCGCAGA
ACTGGCGTACTCAAAGGCCCTCAATATTAG|CCACATTGATAATTTGACTAAGTCAGCAGT
TCTTGGTAACGTGGTGCGGATTATACTGGC|GGCCCTCAATATTAGCGTTGCAGAGTGCCA
AGAGGCGTACATAAATTCGCAGGGTCTAGC|AGGCCCTCAATATTAGTTACGGAATTTCCA
CCCTGGGAGCATAAATCCCTTAAAATAGCC|GCTCGGTGGTATGGATATACATTCTTACCT
GCCCTCAATATTAGATAACTTGCTGTTAAA|CTAGTTGGTGGCAAAACCCCCGCAGAACTA
GACCGACTGGCGTACTCAAAGGCCCTCAAT|ACCATTGTAAGAACGGTATACTTGTATCCC
ACCGACTGGCGTACTCAAAGGCCCTCAATA|CCATTGTAAGAACGGTATACTTGTATCCCA
CCTCAATACTGGCGTACTCAAAGGCCCTCA|GCAAATGTAAAGCTAGTGTATCTTCGCCAC
TGGCGTACTCAAAGGCCCTCAATACTGGCG|GGGGTTGGCTCCGGGCGCAAATGTAAAGCT
TGTTGCTCATTGACCTTGCGATTGAATGAA|GTGAACGCCCCGTCCTTTGAATGGTGGGTG
CAATACTGGCGTACTCAAAGGCCCTCAATA|AATGTAAAGCTAGTGTATCTTCGCCACTGG
CGTTGCACTTCCCACTCAGCCTGAACAGCC|GGTAACACACTGGCGTACTCAAAGGCCCTC
GTTTTCAGACGAGGACTGGCGTACTCAAAG|GCCTGTACTGGCGTACTCAACTGGCGTACT
CCACTTACCGATGAATTACCTACCAACACT|CTCTGCTGCCGTTTGGAGGGACAGATCGGG
TTAGTCGTCGACGACCCTTGCTCGGTGGTA|CAGTTTTCAGACGAGGACTGGCGTACTCAA
GGCCCTCAATATTAGCGTTGCAGAGTGCCA|TAGGCTTAGTTCATTGGGTCCGTCCCAAAT
TACTCAAAGGCCCTCAATACTGGCGTACTC|TGGCTCCGGGCGCAAATGTAAAGCTAGTGT
TGGGTACTATTCCTCACCCCAACTGGCGTA|ACTACCCGCACGGCATCAATCCCACATTGA
ATCCGACTGGCGTACTCAAAGGCCCTCAAT|AAGCAATACGACCTTGGGTACTATTCCTCA
AGGCCCTCAATATTAGTGAACGCCCCGTCC|CAAAGGCCCTCAATATTAGGGCAGAGATAG
GCCCTCAATATTAGTGAACCACTTACCGAT|TAAAGCCGCCCAATAATGCTCTGCTGCCGT
GCAGAATATAAAGCCGCCCAATAATGCTCT|CGGACTGGCGTACTCAAAGGCCCTCAATAT
AGATAGGTATAAAACAAACCCGATAGGTGC|GCCCTGTTTCATCCGCGGACCTGGGGTTTC
GCGTACTCAAAGGCCCTCAATATTAGGGCA|GCCCTCAATATTAGATAACTTGCTGTTAAA
AGCTATACGAATGCTATCAACGACTTTCCA|CGGTAACTGATCTTGTTGCTCATTGACCTT
TGTGTTGCTCTATCGCATTTAAACTGGCGT|ATGCATAGGTGCCCTGGGAGCATAAATCCC
CAACACTTCTGAATGCTTTATCGTTGTGCG|GATCGGGGTTCTTGGTAACGTGGTGCGGAT
CACTTCTGAATGCTTTATCGTTGTGCGCAC|CGGGGTTCTTGGTAACGTGGTGCGGATTAT
CTAGCTACGGCAGAATATAAAGCCGCCCAA|TTCCATGAGCGGACTGGCGTACTCAAAGGC
GATGAATTACCTACCAACACTTCTGAATGC|CGTTTGGAGGGACAGATCGGGGTTCTTGGT
GTAATGCATAGGTGCCCTGGGAGCATAAAT|CGTCGACGACCCTTGCTCGGTGGTATGGAT
CCTCAATATTAGCGTTGCAGAGTGCCATAC|GCTTAGTTCATTGGGTCCGTCCCAAATGTT
TCTTGTTGCTCATTGACCTTGCGATTGAAT|TTAGTGAACGCCCCGTCCTTTGAATGGTGG
GTGCCCTGGGAGCATAAATCCCTTAAAATA|CTTGCTCGGTGGTATGGATATACATTCTTA
AAGGCCCTCAATATTAGCGTTGCAGAGTGC|ATTAGGCTTAGTTCATTGGGTCCGTCCCAA
GATCTTATGGGGTTGGCTCCGGGCGCAAAT|GCCAAAAATCGACCATGATGAAGAGTAGGG
GGCGTACTCAAAGGCCCTCAATATTAGTGA|CTACGGCAGAATATAAAGCCGCCCAATAAT
TGCAGATAGAGGCGTACATAAATTCGCAGG|TACTCAAAGGCCCTCAATATTAGTTACGGA
CAGCCTGAACAGCCTGTACTGGCGTACTCA|ACTCAAAGGCCCTCAATACTGGCGTACTCA
CTGGCGTACTCAAAGGCCCTCAATATTAGC|AAGGCCCTCAATATTAGGCTTAGTTCATTG
GTCGTCGACGACCCTTGCTCGGTGGTATGG|TTTTCAGACGAGGACTGGCGTACTCAAAGG
CTGAACAGCCTGTACTGGCGTACTCAACTG|AAAGGCCCTCAATACTGGCGTACTCAAAGG
AAAAATCGACCATGATGAAGAGTAGGGAGA|GTCGCGTACACCTGTATTAAAAGCCGGTAC
GTATCTTCGCCACTGGCGTACTCAAAGGCC|CGTACTCAAAGGCCCTCAATATTAGAGCTA
ATGTTTGTAATGCATAGGTGCCCTGGGAGC|ATTAGTCGTCGACGACCCTTGCTCGGTGGT
ATCGTTGTGCGCACTAATCCATGCAGATAG|GTGGTGCGGATTATACTGGCGTACTCAAAG
GGCGTACTCAAAGGCCCTCAATATTAGGCT|CGACCTTGGGTACTATTCCTCACCCCAACT
AGACCAGACATCCGACTGGCGTACTCAAAG|CTGCTAAAGAAGCAATACGACCTTGGGTAC
CCACTCAGCCTGAACAGCCTGTACTGGCGT|GGCGTACTCAAAGGCCCTCAATACTGGCGT
CTCAATATTAGTCGTCGACGACCCTTGCTC|AAGTCAGCAGTTTTCAGACGAGGACTGGCG
TTAAATGCCCTGTTTCATCCGCGGACCTGG|AACTACATCGTCAAAACGATCATTACCTAA
AGGCCCTCAATATTAGGGCAGAGATAGGTA|TTAGATAACTTGCTGTTAAATGCCCTGTTT
CGGCATCAATCCCACATTGATAATTTGACT|TGAACAACGTCGCGTTGCACTTCCCACTCA
ACTGGCGTACTCAAAGGCCCTCAATATTAG|TGTAAGAACGGTATACTTGTATCCCATTCA
GGTCTAGCTACGGCAGAATATAAAGCCGCC|AATTTCCATGAGCGGACTGGCGTACTCAAA
TGCTTTATCGTTGTGCGCACTAATCCATGC|GGTAACGTGGTGCGGATTATACTGGCGTAC
TTCTGCCAAAAATCGACCATGATGAAGAGT|CTGACTTGTCGCGTACACCTGTATTAAAAG
ACTGGCGTACTCAAAGGCCCTCAATATTAG|ACTCAACTGGCGTACTCAAAGGCCCTCAAT
ACGACTGCTAAAGAAGCAATACGACCTTGG|CTATACGAATGCTATCAACGACTTTCCACT
CGTACTCAAAGGCCCTCAATATTAGTCTCT|ACTGGCGTACTCAAAGGCCCTCAATATTAG
GAAGAGTAGGGAGACCGACTGGCGTACTCA|TTAAAAGCCGGTACCATTGTAAGAACGGTA
GGTATAAAACAAACCCGATAGGTGCCGATC|GTTTCATCCGCGGACCTGGGGTTTCTGCCA
ACTGGCGTACTCAAAGGCCCTCAATATTAG|TAAATCCCTTAAAATAGCCCTCTTAAACGA
GGACAGATCGGGGTTCTTGGTAACGTGGTG|CTGGCGTACTCAAAGGCCCTCAATATTAGC
AATTTGACTAAGTCAGCAGTTTTCAGACGA|TCCCACTCAGCCTGAACAGCCTGTACTGGC
GTTCATTGGGTCCGTCCCAAATGTTTGTAA|CGTACTCAAAGGCCCTCAATATTAGTCGTC
GCTCTATCGCATTTAAACTGGCGTACTCAA|AGGTGCCCTGGGAGCATAAATCCCTTAAAA
TTCTTGGTAACGTGGTGCGGATTATACTGG|AGGCCCTCAATATTAGCGTTGCAGAGTGCC
TTATACTGGCGTACTCAAAGGCCCTCAATA|CAGAGTGCCATACAGAGTGTGTTGCTCTAT
AATGCTATCAACGACTTTCCACTACCCGCA|ATCTTGTTGCTCATTGACCTTGCGATTGAA
GCCCTCAATATTAGAGACCAGACATCCGAC|GCCCTCTTAAACGACTGCTAAAGAAGCAAT
ATGAAGAGTAGGGAGACCGACTGGCGTACT|TATTAAAAGCCGGTACCATTGTAAGAACGG
TGATAATTTGACTAAGTCAGCAGTTTTCAG|CACTTCCCACTCAGCCTGAACAGCCTGTAC
GATAGGTATAAAACAAACCCGATAGGTGCC|CCCTGTTTCATCCGCGGACCTGGGGTTTCT
ACCTGGTGTAGCTATACGAATGCTATCAAC|GTCTCTTTGCGGTAACTGATCTTGTTGCTC
GCAATACGACCTTGGGTACTATTCCTCACC|CAACGACTTTCCACTACCCGCACGGCATCA
CGGACTGGCGTACTCAAAGGCCCTCAATAT|AAGGCCCTCAATATTAGAGACCAGACATCC
CCTCTTAAACGACTGCTAAAGAAGCAATAC|TGGTGTAGCTATACGAATGCTATCAACGAC
GTGTGTTGCTCTATCGCATTTAAACTGGCG|AATGCATAGGTGCCCTGGGAGCATAAATCC
TTTGACTAAGTCAGCAGTTTTCAGACGAGG|CCACTCAGCCTGAACAGCCTGTACTGGCGT
CGCACTAATCCATGCAGATAGAGGCGTACA|ATTATACTGGCGTACTCAAAGGCCCTCAAT
TGTTAAATGCCCTGTTTCATCCGCGGACCT|AGAACTACATCGTCAAAACGATCATTACCT
TAGTGGCGTACTCAAAGGCCCTCAATATTA|CAAAGGCCCTCAATATTAGATAACTTGCTG
AGAGTGCCATACAGAGTGTGTTGCTCTATC|GTCCCAAATGTTTGTAATGCATAGGTGCCC
CCCTCAATATTAGTGAACGCCCCGTCCTTT|AGGCCCTCAATATTAGGGCAGAGATAGGTA
AGGCCCTCAATATTAGAAGGCCCTCAATAT|TAGATTAGTGGCGTACTCAAAGGCCCTCAA
TTCCATGAGCGGACTGGCGTACTCAAAGGC|GCGTACTCAAAGGCCCTCAATATTAGAGAC
AGACATCCGACTGGCGTACTCAAAGGCCCT|AAAGAAGCAATACGACCTTGGGTACTATTC
TGAACGCCCCGTCCTTTGAATGGTGGGTGC|TAGGGCAGAGATAGGTATAAAACAAACCCG
GCCACTGGCGTACTCAAAGGCCCTCAATAT|AAGGCCCTCAATATTAGAGCTAGTTGGTGG
ATACGACCTTGGGTACTATTCCTCACCCCA|CGACTTTCCACTACCCGCACGGCATCAATC
GGCAGAATATAAAGCCGCCCAATAATGCTC|GCGGACTGGCGTACTCAAAGGCCCTCAATA
AATGCTCTGCTGCCGTTTGGAGGGACAGAT|CTCAATATTAGGTTACGAGCCACTGGCGTA
TGGCGTACTCAAAGGCCCTCAATATTAGAG|AATCCCTTAAAATAGCCCTCTTAAACGACT
CTCAATATTAGATTAGTGGCGTACTCAAAG|CCACTGGCGTACTCAAAGGCCCTCAATATT
GCCCTCAATATTAGAAGGCCCTCAATATTA|GATTAGTGGCGTACTCAAAGGCCCTCAATA
TATTAGAAGGCCCTCAATATTAGTGAACGC|GCGTACTCAAAGGCCCTCAATATTAGGGCA
CGTACTCAAAGGCCCTCAATATTAGATTAG|CTAGTGTATCTTCGCCACTGGCGTACTCAA
AAATGTTTGTAATGCATAGGTGCCCTGGGA|ATATTAGTCGTCGACGACCCTTGCTCGGTG
AAAGGCCCTCAATATTAGTGAACCACTTAC|AATATAAAGCCGCCCAATAATGCTCTGCTG
GGCCCTCAATATTAGTCGTCGACGACCCTT|GACTAAGTCAGCAGTTTTCAGACGAGGACT
CATAAATTCGCAGGGTCTAGCTACGGCAGA|ATATTAGTTACGGAATTTCCATGAGCGGAC
TACTATTCCTCACCCCAACTGGCGTACTCA|CCCGCACGGCATCAATCCCACATTGATAAT
CTAGTGTATCTTCGCCACTGGCGTACTCAA|ACTGGCGTACTCAAAGGCCCTCAATATTAG
GTTACGAGCCACTGGCGTACTCAAAGGCCC|TGGCGTACTCAAAGGCCCTCAATATTAGGC
CCCGCACGGCATCAATCCCACATTGATAAT|ATTGAATGAACAACGTCGCGTTGCACTTCC
AACTGGCGTACTCAAAGGCCCTCAATATTA|CCCACATTGATAATTTGACTAAGTCAGCAG
GTAACGTGGTGCGGATTATACTGGCGTACT|TCAATATTAGCGTTGCAGAGTGCCATACAG
CAAAGGCCCTCAATATTAGTGAACCACTTA|GAATATAAAGCCGCCCAATAATGCTCTGCT
TGGCGTACTCAAAGGCCCTCAATATTAGGC|ACGACCTTGGGTACTATTCCTCACCCCAAC
TACCAACACTTCTGAATGCTTTATCGTTGT|ACAGATCGGGGTTCTTGGTAACGTGGTGCG
CTCAAAGGCCCTCAATATTAGGGCAGAGAT|CAATATTAGATAACTTGCTGTTAAATGCCC
CTTATGGGGTTGGCTCCGGGCGCAAATGTA|AAAAATCGACCATGATGAAGAGTAGGGAGA
TTTCCACTACCCGCACGGCATCAATCCCAC|GACCTTGCGATTGAATGAACAACGTCGCGT
AGCCACTGGCGTACTCAAAGGCCCTCAATA|ACTCAAAGGCCCTCAATATTAGGCTTAGTT
CTGCCGTTTGGAGGGACAGATCGGGGTTCT|AGGTTACGAGCCACTGGCGTACTCAAAGGC
CCCTCAATATTAGCGTTGCAGAGTGCCATA|GGCTTAGTTCATTGGGTCCGTCCCAAATGT
ACCCTGCGGTAACACACTGGCGTACTCAAA|ATAGGTGCCGATCTTATGGGGTTGGCTCCG
GGCGCAAATGTAAAGCTAGTGTATCTTCGC|AGAGTAGGGAGACCGACTGGCGTACTCAAA
TAAAATAGCCCTCTTAAACGACTGCTAAAG|ATTCTTACCTGGTGTAGCTATACGAATGCT
AGGTTACGAGCCACTGGCGTACTCAAAGGC|ACTGGCGTACTCAAAGGCCCTCAATATTAG
CAACTGGCGTACTCAAAGGCCCTCAATATT|TCCCACATTGATAATTTGACTAAGTCAGCA
TCATTGGGTCCGTCCCAAATGTTTGTAATG|TACTCAAAGGCCCTCAATATTAGTCGTCGA
TAGTGAACCACTTACCGATGAATTACCTAC|AATAATGCTCTGCTGCCGTTTGGAGGGACA
CAAAGGCCCTCAATATTAGCGTTGCAGAGT|ATATTAGGCTTAGTTCATTGGGTCCGTCCC
TCAATATTAGATAACTTGCTGTTAAATGCC|TTGGTGGCAAAACCCCCGCAGAACTACATC
GCTGTTAAATGCCCTGTTTCATCCGCGGAC|GCAGAACTACATCGTCAAAACGATCATTAC
ACTGGCGTACTCAAAGGCCCTCAATATTAG|GCCCTCAATATTAGAGCTAGTTGGTGGCAA
GACCATGATGAAGAGTAGGGAGACCGACTG|ACACCTGTATTAAAAGCCGGTACCATTGTA
TGGCGTACTCAAAGGCCCTCAATATTAGGG|AGGCCCTCAATATTAGATAACTTGCTGTTA
TGTAAAGCTAGTGTATCTTCGCCACTGGCG|GAGACCGACTGGCGTACTCAAAGGCCCTCA
TCGGTGGTATGGATATACATTCTTACCTGG|CGTACTCAAAGGCCCTCAATATTAGTCTCT
TACTCAAAGGCCCTCAATATTAGCGTTGCA|CTCAATATTAGGCTTAGTTCATTGGGTCCG
TAGCTACGGCAGAATATAAAGCCGCCCAAT|TCCATGAGCGGACTGGCGTACTCAAAGGCC
GTCCCAAATGTTTGTAATGCATAGGTGCCC|CCTCAATATTAGTCGTCGACGACCCTTGCT
AATATTAGAAGGCCCTCAATATTAGTGAAC|TGGCGTACTCAAAGGCCCTCAATATTAGGG
GTACTGGCGTACTCAACTGGCGTACTCAAA|ATACTGGCGTACTCAAAGGCCCTCAATATT
TGGATATACATTCTTACCTGGTGTAGCTAT|AGGCCCTCAATATTAGTCTCTTTGCGGTAA
GCAGAGTGCCATACAGAGTGTGTTGCTCTA|CCGTCCCAAATGTTTGTAATGCATAGGTGC
GGCGTACATAAATTCGCAGGGTCTAGCTAC|CCCTCAATATTAGTTACGGAATTTCCATGA
GTTGCAGAGTGCCATACAGAGTGTGTTGCT|GGTCCGTCCCAAATGTTTGTAATGCATAGG
TTAGTGAACCACTTACCGATGAATTACCTA|CAATAATGCTCTGCTGCCGTTTGGAGGGAC
CTCAAAGGCCCTCAATATTAGATAACTTGC|ATTAGAGCTAGTTGGTGGCAAAACCCCCGC
CGATAGGTGCCGATCTTATGGGGTTGGCTC|CTGGGGTTTCTGCCAAAAATCGACCATGAT
GATTGAATGAACAACGTCGCGTTGCACTTC|AATGGTGGGTGCACCCTGCGGTAACACACT
GTGTAGCTATACGAATGCTATCAACGACTT|TTTGCGGTAACTGATCTTGTTGCTCATTGA
CTGGCGTACTCAAAGGCCCTCAATATTAGG|CCCTCAATATTAGAGACCAGACATCCGACT
AAGGCCCTCAATATTAGTCGTCGACGACCC|TTGACTAAGTCAGCAGTTTTCAGACGAGGA
TGAACAACGTCGCGTTGCACTTCCCACTCA|GGTGCACCCTGCGGTAACACACTGGCGTAC
AAATTCGCAGGGTCTAGCTACGGCAGAATA|TTAGTTACGGAATTTCCATGAGCGGACTGG
TAGTCTCTTTGCGGTAACTGATCTTGTTGC|AATATTAGAAGGCCCTCAATATTAGTGAAC
GAACCACTTACCGATGAATTACCTACCAAC|ATGCTCTGCTGCCGTTTGGAGGGACAGATC
ATTCGCAGGGTCTAGCTACGGCAGAATATA|AGTTACGGAATTTCCATGAGCGGACTGGCG
TGTAGCTATACGAATGCTATCAACGACTTT|TTGCGGTAACTGATCTTGTTGCTCATTGAC
TGCTCGGTGGTATGGATATACATTCTTACC|TGGCGTACTCAAAGGCCCTCAATATTAGTC
ATAACTTGCTGTTAAATGCCCTGTTTCATC|AACCCCCGCAGAACTACATCGTCAAAACGA
CAATATTAGATTAGTGGCGTACTCAAAGGC|ACTGGCGTACTCAAAGGCCCTCAATATTAG
AATATTAGTCGTCGACGACCCTTGCTCGGT|TCAGCAGTTTTCAGACGAGGACTGGCGTAC
ATTAGTGAACGCCCCGTCCTTTGAATGGTG|AATATTAGGGCAGAGATAGGTATAAAACAA
GCTATCAACGACTTTCCACTACCCGCACGG|TTGTTGCTCATTGACCTTGCGATTGAATGA
CATAAATCCCTTAAAATAGCCCTCTTAAAC|TATGGATATACATTCTTACCTGGTGTAGCT
CCACATTGATAATTTGACTAAGTCAGCAGT|GCGTTGCACTTCCCACTCAGCCTGAACAGC
TCAAAGGCCCTCAATATTAGTCGTCGACGA|AATTTGACTAAGTCAGCAGTTTTCAGACGA
CTAAGTCAGCAGTTTTCAGACGAGGACTGG|CAGCCTGAACAGCCTGTACTGGCGTACTCA
GCATAGGTGCCCTGGGAGCATAAATCCCTT|ACGACCCTTGCTCGGTGGTATGGATATACA
TGTATCTTCGCCACTGGCGTACTCAAAGGC|GCGTACTCAAAGGCCCTCAATATTAGAGCT
AAGGCCCTCAATACTGGCGTACTCAAAGGC|CGGGCGCAAATGTAAAGCTAGTGTATCTTC
ACCCTTGCTCGGTGGTATGGATATACATTC|AGGACTGGCGTACTCAAAGGCCCTCAATAT
GCCAAAAATCGACCATGATGAAGAGTAGGG|CTTGTCGCGTACACCTGTATTAAAAGCCGG
GTGCGGATTATACTGGCGTACTCAAAGGCC|AGCGTTGCAGAGTGCCATACAGAGTGTGTT
CCTCAATATTAGGTTACGAGCCACTGGCGT|CAGACATCCGACTGGCGTACTCAAAGGCCC
CAACCACTGGCGTACTCAAAGGCCCTCAAT|GGGTCTAGCTACGGCAGAATATAAAGCCGC
GTACTCAAAGGCCCTCAATATTAGGTTACG|AATATTAGAGACCAGACATCCGACTGGCGT
TGTTGCTCTATCGCATTTAAACTGGCGTAC|GCATAGGTGCCCTGGGAGCATAAATCCCTT
CGTCGCGTTGCACTTCCCACTCAGCCTGAA|CCTGCGGTAACACACTGGCGTACTCAAAGG
CTGGCGTACTCAAAGGCCCTCAATATTAGT|AGCTACGGCAGAATATAAAGCCGCCCAATA
CAAAGGCCCTCAATATTAGTCTCTTTGCGG|GTACTCAAAGGCCCTCAATATTAGAAGGCC
TCAAAGGCCCTCAATATTAGAAGGCCCTCA|ATATTAGATTAGTGGCGTACTCAAAGGCCC
ATTAGATAACTTGCTGTTAAATGCCCTGTT|GGCAAAACCCCCGCAGAACTACATCGTCAA
GGCCCTCAATATTAGTCTCTTTGCGGTAAC|TCAAAGGCCCTCAATATTAGAAGGCCCTCA
TAGGGCAGAGATAGGTATAAAACAAACCCG|TGTTAAATGCCCTGTTTCATCCGCGGACCT
ACGTGGTGCGGATTATACTGGCGTACTCAA|ATATTAGCGTTGCAGAGTGCCATACAGAGT
ACTAATCCATGCAGATAGAGGCGTACATAA|ATACTGGCGTACTCAAAGGCCCTCAATATT
CATCCGACTGGCGTACTCAAAGGCCCTCAA|GAAGCAATACGACCTTGGGTACTATTCCTC
CCTCAATATTAGTCGTCGACGACCCTTGCT|TAAGTCAGCAGTTTTCAGACGAGGACTGGC
TCATTGACCTTGCGATTGAATGAACAACGT|GCCCCGTCCTTTGAATGGTGGGTGCACCCT
CGGGCGCAAATGTAAAGCTAGTGTATCTTC|GAAGAGTAGGGAGACCGACTGGCGTACTCA
ACTCAAAGGCCCTCAATATTAGGTTACGAG|TATTAGAGACCAGACATCCGACTGGCGTAC
CTCAGCCTGAACAGCCTGTACTGGCGTACT|GTACTCAAAGGCCCTCAATACTGGCGTACT
GACATCCGACTGGCGTACTCAAAGGCCCTC|AAGAAGCAATACGACCTTGGGTACTATTCC
TTAGAAGGCCCTCAATATTAGTGAACGCCC|GTACTCAAAGGCCCTCAATATTAGGGCAGA
CTAAAGAAGCAATACGACCTTGGGTACTAT|AATGCTATCAACGACTTTCCACTACCCGCA
GCTAGTGTATCTTCGCCACTGGCGTACTCA|GACTGGCGTACTCAAAGGCCCTCAATATTA
CCCTCAATATTAGGGCAGAGATAGGTATAA|GATAACTTGCTGTTAAATGCCCTGTTTCAT
GGCCCTCAATATTAGAAGGCCCTCAATATT|AGATTAGTGGCGTACTCAAAGGCCCTCAAT
AGAGACCAGACATCCGACTGGCGTACTCAA|GACTGCTAAAGAAGCAATACGACCTTGGGT
ACCGATGAATTACCTACCAACACTTCTGAA|TGCCGTTTGGAGGGACAGATCGGGGTTCTT
CAAAAATCGACCATGATGAAGAGTAGGGAG|TGTCGCGTACACCTGTATTAAAAGCCGGTA
AGGCCCTCAATATTAGTCGTCGACGACCCT|TGACTAAGTCAGCAGTTTTCAGACGAGGAC
TCCCAAATGTTTGTAATGCATAGGTGCCCT|CTCAATATTAGTCGTCGACGACCCTTGCTC
GCCCTCAATATTAGGTTACGAGCCACTGGC|ACCAGACATCCGACTGGCGTACTCAAAGGC
ACGAGCCACTGGCGTACTCAAAGGCCCTCA|CGTACTCAAAGGCCCTCAATATTAGGCTTA
CGGTAACACACTGGCGTACTCAAAGGCCCT|GCCGATCTTATGGGGTTGGCTCCGGGCGCA
AAAATAGCCCTCTTAAACGACTGCTAAAGA|TTCTTACCTGGTGTAGCTATACGAATGCTA
AATTACCTACCAACACTTCTGAATGCTTTA|TGGAGGGACAGATCGGGGTTCTTGGTAACG
CGTACTCAAAGGCCCTCAATATTAGTTACG|ATACAGAGTGTGTTGCTCTATCGCATTTAA
TGCAGAGTGCCATACAGAGTGTGTTGCTCT|TCCGTCCCAAATGTTTGTAATGCATAGGTG
TTGAATGGTGGGTGCACCCTGCGGTAACAC|TATAAAACAAACCCGATAGGTGCCGATCTT
GCAGGGTCTAGCTACGGCAGAATATAAAGC|ACGGAATTTCCATGAGCGGACTGGCGTACT
GCTGCCGTTTGGAGGGACAGATCGGGGTTC|TAGGTTACGAGCCACTGGCGTACTCAAAGG
CTCAATATTAGTGAACGCCCCGTCCTTTGA|GCCCTCAATATTAGGGCAGAGATAGGTATA
AAAGGCCCTCAATATTAGGCTTAGTTCATT|GTACTATTCCTCACCCCAACTGGCGTACTC
CGACTTTCCACTACCCGCACGGCATCAATC|CATTGACCTTGCGATTGAATGAACAACGTC
GAGCATAAATCCCTTAAAATAGCCCTCTTA|TGGTATGGATATACATTCTTACCTGGTGTA
AGTGGCGTACTCAAAGGCCCTCAATATTAG|AAAGGCCCTCAATATTAGATAACTTGCTGT
ACGGAATTTCCATGAGCGGACTGGCGTACT|TAAACTGGCGTACTCAAAGGCCCTCAATAT
CCCTCAATACTGGCGTACTCAAAGGCCCTC|CGCAAATGTAAAGCTAGTGTATCTTCGCCA
ATACTGGCGTACTCAAAGGCCCTCAATATT|TGTAAAGCTAGTGTATCTTCGCCACTGGCG
CGTACTCAAAGGCCCTCAATATTAGCGTTG|CCCTCAATATTAGGCTTAGTTCATTGGGTC
CCATGATGAAGAGTAGGGAGACCGACTGGC|ACCTGTATTAAAAGCCGGTACCATTGTAAG
CAAATGTTTGTAATGCATAGGTGCCCTGGG|AATATTAGTCGTCGACGACCCTTGCTCGGT
TTGAATGAACAACGTCGCGTTGCACTTCCC|TGGTGGGTGCACCCTGCGGTAACACACTGG
ATACTGGCGTACTCAAAGGCCCTCAATATT|GAGTGCCATACAGAGTGTGTTGCTCTATCG
TCAATATTAGTCGTCGACGACCCTTGCTCG|AGTCAGCAGTTTTCAGACGAGGACTGGCGT
CGTACTCAAAGGCCCTCAATATTAGGGCAG|CCCTCAATATTAGATAACTTGCTGTTAAAT
CAAAGGCCCTCAATATTAGGGCAGAGATAG|ATATTAGATAACTTGCTGTTAAATGCCCTG
GAGGGACAGATCGGGGTTCTTGGTAACGTG|CCACTGGCGTACTCAAAGGCCCTCAATATT
TGCCATACAGAGTGTGTTGCTCTATCGCAT|CAAATGTTTGTAATGCATAGGTGCCCTGGG
TCTAGCTACGGCAGAATATAAAGCCGCCCA|TTTCCATGAGCGGACTGGCGTACTCAAAGG
CATTTAAACTGGCGTACTCAAAGGCCCTCA|GGGAGCATAAATCCCTTAAAATAGCCCTCT
CCGTCCTTTGAATGGTGGGTGCACCCTGCG|AGATAGGTATAAAACAAACCCGATAGGTGC
GAGTGTGTTGCTCTATCGCATTTAAACTGG|GTAATGCATAGGTGCCCTGGGAGCATAAAT
TCTGCTGCCGTTTGGAGGGACAGATCGGGG|TATTAGGTTACGAGCCACTGGCGTACTCAA
CGTGGTGCGGATTATACTGGCGTACTCAAA|TATTAGCGTTGCAGAGTGCCATACAGAGTG
GCCGTTTGGAGGGACAGATCGGGGTTCTTG|GTTACGAGCCACTGGCGTACTCAAAGGCCC
ATTTCCATGAGCGGACTGGCGTACTCAAAG|TGGCGTACTCAAAGGCCCTCAATATTAGAG
GGCCCTCAATATTAGTGAACGCCCCGTCCT|AAAGGCCCTCAATATTAGGGCAGAGATAGG
TCAATATTAGATTAGTGGCGTACTCAAAGG|CACTGGCGTACTCAAAGGCCCTCAATATTA
CTGCTAAAGAAGCAATACGACCTTGGGTAC|ACGAATGCTATCAACGACTTTCCACTACCC
GACCTGGGGTTTCTGCCAAAAATCGACCAT|TACCTAACCCCTGACTTGTCGCGTACACCT
AAGTCAGCAGTTTTCAGACGAGGACTGGCG|GCCTGAACAGCCTGTACTGGCGTACTCAAC
GCGTACATAAATTCGCAGGGTCTAGCTACG|CCTCAATATTAGTTACGGAATTTCCATGAG
TAGCCCTCTTAAACGACTGCTAAAGAAGCA|TACCTGGTGTAGCTATACGAATGCTATCAA
CCCACATTGATAATTTGACTAAGTCAGCAG|CGCGTTGCACTTCCCACTCAGCCTGAACAG
AAGGCCCTCAATATTAGATAACTTGCTGTT|GAGCTAGTTGGTGGCAAAACCCCCGCAGAA
GTACTCAAAGGCCCTCAATATTAGATAACT|AATATTAGAGCTAGTTGGTGGCAAAACCCC
TCAAAGGCCCTCAATATTAGGCTTAGTTCA|GGGTACTATTCCTCACCCCAACTGGCGTAC
AGAGTGTGTTGCTCTATCGCATTTAAACTG|TGTAATGCATAGGTGCCCTGGGAGCATAAA
TGGTGTAGCTATACGAATGCTATCAACGAC|TCTTTGCGGTAACTGATCTTGTTGCTCATT
ACTCAAAGGCCCTCAATATTAGATTAGTGG|GTGTATCTTCGCCACTGGCGTACTCAAAGG
CGAGCCACTGGCGTACTCAAAGGCCCTCAA|GTACTCAAAGGCCCTCAATATTAGGCTTAG
TTTGGAGGGACAGATCGGGGTTCTTGGTAA|CGAGCCACTGGCGTACTCAAAGGCCCTCAA
GCGTTGCAGAGTGCCATACAGAGTGTGTTG|TGGGTCCGTCCCAAATGTTTGTAATGCATA
TCCGACTGGCGTACTCAAAGGCCCTCAATA|AGCAATACGACCTTGGGTACTATTCCTCAC
GAGCCACTGGCGTACTCAAAGGCCCTCAAT|TACTCAAAGGCCCTCAATATTAGGCTTAGT
TGCGCACTAATCCATGCAGATAGAGGCGTA|GGATTATACTGGCGTACTCAAAGGCCCTCA
ATTAGAAGGCCCTCAATATTAGTGAACGCC|CGTACTCAAAGGCCCTCAATATTAGGGCAG
TTAGCGTTGCAGAGTGCCATACAGAGTGTG|CATTGGGTCCGTCCCAAATGTTTGTAATGC
GGATATACATTCTTACCTGGTGTAGCTATA|GGCCCTCAATATTAGTCTCTTTGCGGTAAC
CCGCACGGCATCAATCCCACATTGATAATT|TTGAATGAACAACGTCGCGTTGCACTTCCC
CGGTAACTGATCTTGTTGCTCATTGACCTT|GCCCTCAATATTAGTGAACGCCCCGTCCTT
TACCGATGAATTACCTACCAACACTTCTGA|CTGCCGTTTGGAGGGACAGATCGGGGTTCT
ATAAATTCGCAGGGTCTAGCTACGGCAGAA|TATTAGTTACGGAATTTCCATGAGCGGACT
CATTGGGTCCGTCCCAAATGTTTGTAATGC|ACTCAAAGGCCCTCAATATTAGTCGTCGAC
CTATCAACGACTTTCCACTACCCGCACGGC|TGTTGCTCATTGACCTTGCGATTGAATGAA
CCACTACCCGCACGGCATCAATCCCACATT|CTTGCGATTGAATGAACAACGTCGCGTTGC
CCTGGGAGCATAAATCCCTTAAAATAGCCC|CTCGGTGGTATGGATATACATTCTTACCTG
CCTCACCCCAACTGGCGTACTCAAAGGCCC|GGCATCAATCCCACATTGATAATTTGACTA
AATGGTGGGTGCACCCTGCGGTAACACACT|AAAACAAACCCGATAGGTGCCGATCTTATG
GGCCCTCAATATTAGGGCAGAGATAGGTAT|TAGATAACTTGCTGTTAAATGCCCTGTTTC
ACAGATCGGGGTTCTTGGTAACGTGGTGCG|GGCGTACTCAAAGGCCCTCAATATTAGCGT
CTATCGCATTTAAACTGGCGTACTCAAAGG|TGCCCTGGGAGCATAAATCCCTTAAAATAG
AGAGTAGGGAGACCGACTGGCGTACTCAAA|AAAAGCCGGTACCATTGTAAGAACGGTATA
ATGATGAAGAGTAGGGAGACCGACTGGCGT|CTGTATTAAAAGCCGGTACCATTGTAAGAA
TACCCGCACGGCATCAATCCCACATTGATA|CGATTGAATGAACAACGTCGCGTTGCACTT
GTTGTGCGCACTAATCCATGCAGATAGAGG|GTGCGGATTATACTGGCGTACTCAAAGGCC
GCCCTCAATATTAGGCTTAGTTCATTGGGT|TATTCCTCACCCCAACTGGCGTACTCAAAG
ATTAGAGACCAGACATCCGACTGGCGTACT|AACGACTGCTAAAGAAGCAATACGACCTTG
GAGGCGTACATAAATTCGCAGGGTCTAGCT|GGCCCTCAATATTAGTTACGGAATTTCCAT
AGGGACAGATCGGGGTTCTTGGTAACGTGG|CACTGGCGTACTCAAAGGCCCTCAATATTA
CCGCCCAATAATGCTCTGCTGCCGTTTGGA|TCAAAGGCCCTCAATATTAGGTTACGAGCC
TAAAGCCGCCCAATAATGCTCTGCTGCCGT|CGTACTCAAAGGCCCTCAATATTAGGTTAC
TCCCTTAAAATAGCCCTCTTAAACGACTGC|TATACATTCTTACCTGGTGTAGCTATACGA
CCTTAAAATAGCCCTCTTAAACGACTGCTA|TACATTCTTACCTGGTGTAGCTATACGAAT
CTGTACTGGCGTACTCAACTGGCGTACTCA|CAATACTGGCGTACTCAAAGGCCCTCAATA
GTCCTTTGAATGGTGGGTGCACCCTGCGGT|ATAGGTATAAAACAAACCCGATAGGTGCCG
CTCAAAGGCCCTCAATATTAGGTTACGAGC|ATTAGAGACCAGACATCCGACTGGCGTACT
ATGAATTACCTACCAACACTTCTGAATGCT|GTTTGGAGGGACAGATCGGGGTTCTTGGTA
GGTGCCGATCTTATGGGGTTGGCTCCGGGC|GTTTCTGCCAAAAATCGACCATGATGAAGA
GTAGCTATACGAATGCTATCAACGACTTTC|TGCGGTAACTGATCTTGTTGCTCATTGACC
AGGACTGGCGTACTCAAAGGCCCTCAATAT|CGTACTCAACTGGCGTACTCAAAGGCCCTC
CGCATTTAAACTGGCGTACTCAAAGGCCCT|CTGGGAGCATAAATCCCTTAAAATAGCCCT
CTCAATACTGGCGTACTCAAAGGCCCTCAA|CAAATGTAAAGCTAGTGTATCTTCGCCACT
CGCGGACCTGGGGTTTCTGCCAAAAATCGA|TCATTACCTAACCCCTGACTTGTCGCGTAC
CGCACGGCATCAATCCCACATTGATAATTT|TGAATGAACAACGTCGCGTTGCACTTCCCA
GGTAACACACTGGCGTACTCAAAGGCCCTC|CCGATCTTATGGGGTTGGCTCCGGGCGCAA
ATATTAGATTAGTGGCGTACTCAAAGGCCC|TGGCGTACTCAAAGGCCCTCAATATTAGAT
ATGCTCTGCTGCCGTTTGGAGGGACAGATC|TCAATATTAGGTTACGAGCCACTGGCGTAC
AAAGGCCCTCAATATTAGAGACCAGACATC|AATAGCCCTCTTAAACGACTGCTAAAGAAG
GAACAGCCTGTACTGGCGTACTCAACTGGC|AGGCCCTCAATACTGGCGTACTCAAAGGCC
TAGCTATACGAATGCTATCAACGACTTTCC|GCGGTAACTGATCTTGTTGCTCATTGACCT
CTCTGCTGCCGTTTGGAGGGACAGATCGGG|ATATTAGGTTACGAGCCACTGGCGTACTCA
CAGATAGAGGCGTACATAAATTCGCAGGGT|CTCAAAGGCCCTCAATATTAGTTACGGAAT
ACGCCCCGTCCTTTGAATGGTGGGTGCACC|GGCAGAGATAGGTATAAAACAAACCCGATA
GGGTCTAGCTACGGCAGAATATAAAGCCGC|GAATTTCCATGAGCGGACTGGCGTACTCAA
ATCCCTTAAAATAGCCCTCTTAAACGACTG|ATATACATTCTTACCTGGTGTAGCTATACG
TGTAATGCATAGGTGCCCTGGGAGCATAAA|TCGTCGACGACCCTTGCTCGGTGGTATGGA
CTCAATATTAGAGACCAGACATCCGACTGG|CTCTTAAACGACTGCTAAAGAAGCAATACG
ATAAATCCCTTAAAATAGCCCTCTTAAACG|ATGGATATACATTCTTACCTGGTGTAGCTA
GGGACAGATCGGGGTTCTTGGTAACGTGGT|ACTGGCGTACTCAAAGGCCCTCAATATTAG
CGTCCCAAATGTTTGTAATGCATAGGTGCC|CCCTCAATATTAGTCGTCGACGACCCTTGC
TACAGAGTGTGTTGCTCTATCGCATTTAAA|GTTTGTAATGCATAGGTGCCCTGGGAGCAT
TCGCGTTGCACTTCCCACTCAGCCTGAACA|TGCGGTAACACACTGGCGTACTCAAAGGCC
TCGTCGACGACCCTTGCTCGGTGGTATGGA|TTTCAGACGAGGACTGGCGTACTCAAAGGC
GCCTGTACTGGCGTACTCAACTGGCGTACT|CTCAATACTGGCGTACTCAAAGGCCCTCAA
TTCATCCGCGGACCTGGGGTTTCTGCCAAA|AAACGATCATTACCTAACCCCTGACTTGTC
CTGGGGTTTCTGCCAAAAATCGACCATGAT|CTAACCCCTGACTTGTCGCGTACACCTGTA
ATACGAATGCTATCAACGACTTTCCACTAC|AACTGATCTTGTTGCTCATTGACCTTGCGA
GGCCCTCAATACTGGCGTACTCAAAGGCCC|GGCGCAAATGTAAAGCTAGTGTATCTTCGC
CAAAGGCCCTCAATATTAGGCTTAGTTCAT|GGTACTATTCCTCACCCCAACTGGCGTACT
GAGACCGACTGGCGTACTCAAAGGCCCTCA|GTACCATTGTAAGAACGGTATACTTGTATC
AATGAACAACGTCGCGTTGCACTTCCCACT|TGGGTGCACCCTGCGGTAACACACTGGCGT
CTCCGGGCGCAAATGTAAAGCTAGTGTATC|GATGAAGAGTAGGGAGACCGACTGGCGTAC
CGTACTCAACTGGCGTACTCAAAGGCCCTC|CGTACTCAAAGGCCCTCAATATTAGATTAG
TGCTCTATCGCATTTAAACTGGCGTACTCA|TAGGTGCCCTGGGAGCATAAATCCCTTAAA
GACCTTGCGATTGAATGAACAACGTCGCGT|GTCCTTTGAATGGTGGGTGCACCCTGCGGT
CAATAATGCTCTGCTGCCGTTTGGAGGGAC|GGCCCTCAATATTAGGTTACGAGCCACTGG
TTCTTACCTGGTGTAGCTATACGAATGCTA|TATTAGTCTCTTTGCGGTAACTGATCTTGT
TAGATAACTTGCTGTTAAATGCCCTGTTTC|CAAAACCCCCGCAGAACTACATCGTCAAAA
AGTCGTCGACGACCCTTGCTCGGTGGTATG|GTTTTCAGACGAGGACTGGCGTACTCAAAG
ACTGGCGTACTCAAAGGCCCTCAATATTAG|GTGCCATACAGAGTGTGTTGCTCTATCGCA
CAATACGACCTTGGGTACTATTCCTCACCC|AACGACTTTCCACTACCCGCACGGCATCAA
GACCCTTGCTCGGTGGTATGGATATACATT|GAGGACTGGCGTACTCAAAGGCCCTCAATA
CTCACCCCAACTGGCGTACTCAAAGGCCCT|GCATCAATCCCACATTGATAATTTGACTAA
TTGCTCATTGACCTTGCGATTGAATGAACA|GAACGCCCCGTCCTTTGAATGGTGGGTGCA
GCCCTCAATATTAGATTAGTGGCGTACTCA|TCGCCACTGGCGTACTCAAAGGCCCTCAAT
TCTTCGCCACTGGCGTACTCAAAGGCCCTC|ACTCAAAGGCCCTCAATATTAGAGCTAGTT
GCTTAGTTCATTGGGTCCGTCCCAAATGTT|ACTGGCGTACTCAAAGGCCCTCAATATTAG
GGCCCTCAATATTAGAGACCAGACATCCGA|AGCCCTCTTAAACGACTGCTAAAGAAGCAA
ATATTAGTGAACGCCCCGTCCTTTGAATGG|TCAATATTAGGGCAGAGATAGGTATAAAAC
ATTAGCGTTGCAGAGTGCCATACAGAGTGT|TCATTGGGTCCGTCCCAAATGTTTGTAATG
AGCTAGTGTATCTTCGCCACTGGCGTACTC|CGACTGGCGTACTCAAAGGCCCTCAATATT
ATTTAAACTGGCGTACTCAAAGGCCCTCAA|GGAGCATAAATCCCTTAAAATAGCCCTCTT
GGGGTTTCTGCCAAAAATCGACCATGATGA|AACCCCTGACTTGTCGCGTACACCTGTATT
AAAGGCCCTCAATATTAGTCGTCGACGACC|TTTGACTAAGTCAGCAGTTTTCAGACGAGG
CCCTGCGGTAACACACTGGCGTACTCAAAG|TAGGTGCCGATCTTATGGGGTTGGCTCCGG
GATTATACTGGCGTACTCAAAGGCCCTCAA|TGCAGAGTGCCATACAGAGTGTGTTGCTCT
GGGGTTGGCTCCGGGCGCAAATGTAAAGCT|TCGACCATGATGAAGAGTAGGGAGACCGAC
GCCCTCAATATTAGTGAACGCCCCGTCCTT|AAGGCCCTCAATATTAGGGCAGAGATAGGT
CGACCATGATGAAGAGTAGGGAGACCGACT|TACACCTGTATTAAAAGCCGGTACCATTGT
AATATAAAGCCGCCCAATAATGCTCTGCTG|CTGGCGTACTCAAAGGCCCTCAATATTAGG
GGGTTGGCTCCGGGCGCAAATGTAAAGCTA|CGACCATGATGAAGAGTAGGGAGACCGACT
ATAGAGGCGTACATAAATTCGCAGGGTCTA|AAAGGCCCTCAATATTAGTTACGGAATTTC
CCTGTTTCATCCGCGGACCTGGGGTTTCTG|CGTCAAAACGATCATTACCTAACCCCTGAC
GACTAAGTCAGCAGTTTTCAGACGAGGACT|CTCAGCCTGAACAGCCTGTACTGGCGTACT
CGTACTCAAAGGCCCTCAATATTAGAGACC|CCCTTAAAATAGCCCTCTTAAACGACTGCT
TGCATAGGTGCCCTGGGAGCATAAATCCCT|GACGACCCTTGCTCGGTGGTATGGATATAC
CGTACTCAAAGGCCCTCAATACTGGCGTAC|GTTGGCTCCGGGCGCAAATGTAAAGCTAGT
ATTTGACTAAGTCAGCAGTTTTCAGACGAG|CCCACTCAGCCTGAACAGCCTGTACTGGCG
CAAAGGCCCTCAATATTAGAGACCAGACAT|AAATAGCCCTCTTAAACGACTGCTAAAGAA
AATCCATGCAGATAGAGGCGTACATAAATT|CTGGCGTACTCAAAGGCCCTCAATATTAGT
GTACTCAAAGGCCCTCAATATTAGGCTTAG|CCTTGGGTACTATTCCTCACCCCAACTGGC
CCCCGTCCTTTGAATGGTGGGTGCACCCTG|AGAGATAGGTATAAAACAAACCCGATAGGT
GTACTCAAAGGCCCTCAATATTAGTTACGG|TACAGAGTGTGTTGCTCTATCGCATTTAAA
GTGCCATACAGAGTGTGTTGCTCTATCGCA|CCAAATGTTTGTAATGCATAGGTGCCCTGG
TATTAGTTACGGAATTTCCATGAGCGGACT|ATCGCATTTAAACTGGCGTACTCAAAGGCC
AGATTAGTGGCGTACTCAAAGGCCCTCAAT|TACTCAAAGGCCCTCAATATTAGATAACTT
ACTGGCGTACTCAAAGGCCCTCAATATTAG|ATACGACCTTGGGTACTATTCCTCACCCCA
GTACTATTCCTCACCCCAACTGGCGTACTC|ACCCGCACGGCATCAATCCCACATTGATAA
ATCGACCATGATGAAGAGTAGGGAGACCGA|CGTACACCTGTATTAAAAGCCGGTACCATT
CCAAAAATCGACCATGATGAAGAGTAGGGA|TTGTCGCGTACACCTGTATTAAAAGCCGGT
CTTCGCCACTGGCGTACTCAAAGGCCCTCA|CTCAAAGGCCCTCAATATTAGAGCTAGTTG
AAGGCCCTCAATATTAGGTTACGAGCCACT|GAGACCAGACATCCGACTGGCGTACTCAAA
AGACCGACTGGCGTACTCAAAGGCCCTCAA|TACCATTGTAAGAACGGTATACTTGTATCC
GGGCAGAGATAGGTATAAAACAAACCCGAT|TTAAATGCCCTGTTTCATCCGCGGACCTGG
ATATTAGAAGGCCCTCAATATTAGTGAACG|GGCGTACTCAAAGGCCCTCAATATTAGGGC
GATAGGTGCCGATCTTATGGGGTTGGCTCC|TGGGGTTTCTGCCAAAAATCGACCATGATG
GTACTCAAAGGCCCTCAATATTAGGGCAGA|CCTCAATATTAGATAACTTGCTGTTAAATG
CGACTGGCGTACTCAAAGGCCCTCAATATT|ATTGTAAGAACGGTATACTTGTATCCCATT
CATTCTTACCTGGTGTAGCTATACGAATGC|AATATTAGTCTCTTTGCGGTAACTGATCTT
ACTCAAAGGCCCTCAATATTAGGGCAGAGA|TCAATATTAGATAACTTGCTGTTAAATGCC
CTCAATATTAGTTACGGAATTTCCATGAGC|GCTCTATCGCATTTAAACTGGCGTACTCAA
ATAAAGCCGCCCAATAATGCTCTGCTGCCG|GCGTACTCAAAGGCCCTCAATATTAGGTTA
CCCTTGCTCGGTGGTATGGATATACATTCT|GGACTGGCGTACTCAAAGGCCCTCAATATT
GCGTACTCAAAGGCCCTCAATATTAGGCTT|GACCTTGGGTACTATTCCTCACCCCAACTG
GCATTTAAACTGGCGTACTCAAAGGCCCTC|TGGGAGCATAAATCCCTTAAAATAGCCCTC
ACTCAAAGGCCCTCAATATTAGATAACTTG|TATTAGAGCTAGTTGGTGGCAAAACCCCCG
GGCCCTCAATATTAGGTTACGAGCCACTGG|GACCAGACATCCGACTGGCGTACTCAAAGG
GGTGCACCCTGCGGTAACACACTGGCGTAC|ACCCGATAGGTGCCGATCTTATGGGGTTGG
AACCACTTACCGATGAATTACCTACCAACA|TGCTCTGCTGCCGTTTGGAGGGACAGATCG
GGTGCCCTGGGAGCATAAATCCCTTAAAAT|CCTTGCTCGGTGGTATGGATATACATTCTT
TCAATCCCACATTGATAATTTGACTAAGTC|AACGTCGCGTTGCACTTCCCACTCAGCCTG
CTCAATATTAGATAACTTGCTGTTAAATGC|GTTGGTGGCAAAACCCCCGCAGAACTACAT
ACTACCCGCACGGCATCAATCCCACATTGA|TGCGATTGAATGAACAACGTCGCGTTGCAC
GGGTTCTTGGTAACGTGGTGCGGATTATAC|CAAAGGCCCTCAATATTAGCGTTGCAGAGT
TTTGTAATGCATAGGTGCCCTGGGAGCATA|AGTCGTCGACGACCCTTGCTCGGTGGTATG
CTCAAAGGCCCTCAATATTAGTTACGGAAT|AGAGTGTGTTGCTCTATCGCATTTAAACTG
TAAATTCGCAGGGTCTAGCTACGGCAGAAT|ATTAGTTACGGAATTTCCATGAGCGGACTG
ACTCAAAGGCCCTCAATATTAGTCTCTTTG|GGCGTACTCAAAGGCCCTCAATATTAGAAG
CTCAAAGGCCCTCAATATTAGATTAGTGGC|TGTATCTTCGCCACTGGCGTACTCAAAGGC
CAACGACTTTCCACTACCCGCACGGCATCA|GCTCATTGACCTTGCGATTGAATGAACAAC
TCAAAGGCCCTCAATATTAGAGACCAGACA|AAAATAGCCCTCTTAAACGACTGCTAAAGA
CCCACTCAGCCTGAACAGCCTGTACTGGCG|TGGCGTACTCAAAGGCCCTCAATACTGGCG
CCTCAATATTAGGCTTAGTTCATTGGGTCC|TTCCTCACCCCAACTGGCGTACTCAAAGGC
GGCGTACTCAAAGGCCCTCAATATTAGAGC|AAGAACGGTATACTTGTATCCCATTCAAGG
ACTGGCGTACTCAAAGGCCCTCAATATTAG|GCCCTCAATATTAGAGACCAGACATCCGAC
ATTAGTTACGGAATTTCCATGAGCGGACTG|TCGCATTTAAACTGGCGTACTCAAAGGCCC
CCTCAATATTAGAAGGCCCTCAATATTAGT|TTAGTGGCGTACTCAAAGGCCCTCAATATT
TTGGTAACGTGGTGCGGATTATACTGGCGT|CCCTCAATATTAGCGTTGCAGAGTGCCATA
GGTACTATTCCTCACCCCAACTGGCGTACT|TACCCGCACGGCATCAATCCCACATTGATA
TGATGAAGAGTAGGGAGACCGACTGGCGTA|TGTATTAAAAGCCGGTACCATTGTAAGAAC
AGAAGGCCCTCAATATTAGTGAACGCCCCG|ACTCAAAGGCCCTCAATATTAGGGCAGAGA
TCCGTCCCAAATGTTTGTAATGCATAGGTG|GGCCCTCAATATTAGTCGTCGACGACCCTT
TTATCGTTGTGCGCACTAATCCATGCAGAT|ACGTGGTGCGGATTATACTGGCGTACTCAA
CAGGGTCTAGCTACGGCAGAATATAAAGCC|CGGAATTTCCATGAGCGGACTGGCGTACTC
CCGTTTGGAGGGACAGATCGGGGTTCTTGG|TTACGAGCCACTGGCGTACTCAAAGGCCCT
CCTGCGGTAACACACTGGCGTACTCAAAGG|AGGTGCCGATCTTATGGGGTTGGCTCCGGG
TACGGAATTTCCATGAGCGGACTGGCGTAC|TTAAACTGGCGTACTCAAAGGCCCTCAATA
AAAGGCCCTCAATATTAGTCTCTTTGCGGT|TACTCAAAGGCCCTCAATATTAGAAGGCCC
GTACTCAAAGGCCCTCAATATTAGTCGTCG|TGATAATTTGACTAAGTCAGCAGTTTTCAG
TTAGTTACGGAATTTCCATGAGCGGACTGG|CGCATTTAAACTGGCGTACTCAAAGGCCCT
GTTACGGAATTTCCATGAGCGGACTGGCGT|ATTTAAACTGGCGTACTCAAAGGCCCTCAA
GGAGCATAAATCCCTTAAAATAGCCCTCTT|GTGGTATGGATATACATTCTTACCTGGTGT
TAACACACTGGCGTACTCAAAGGCCCTCAA|GATCTTATGGGGTTGGCTCCGGGCGCAAAT
TGATCTTGTTGCTCATTGACCTTGCGATTG|ATATTAGTGAACGCCCCGTCCTTTGAATGG
GGAGACCGACTGGCGTACTCAAAGGCCCTC|GGTACCATTGTAAGAACGGTATACTTGTAT
AAATGCCCTGTTTCATCCGCGGACCTGGGG|CTACATCGTCAAAACGATCATTACCTAACC
TTGCTCGGTGGTATGGATATACATTCTTAC|CTGGCGTACTCAAAGGCCCTCAATATTAGT
AGGCCCTCAATATTAGTTACGGAATTTCCA|GTGTTGCTCTATCGCATTTAAACTGGCGTA
GTGTTGCTCTATCGCATTTAAACTGGCGTA|TGCATAGGTGCCCTGGGAGCATAAATCCCT
GATCGGGGTTCTTGGTAACGTGGTGCGGAT|GTACTCAAAGGCCCTCAATATTAGCGTTGC
TCCTTTGAATGGTGGGTGCACCCTGCGGTA|TAGGTATAAAACAAACCCGATAGGTGCCGA
TCAAAGGCCCTCAATATTAGTTACGGAATT|GAGTGTGTTGCTCTATCGCATTTAAACTGG
CCTGGTGTAGCTATACGAATGCTATCAACG|TCTCTTTGCGGTAACTGATCTTGTTGCTCA
CCCTCAATATTAGTTACGGAATTTCCATGA|TTGCTCTATCGCATTTAAACTGGCGTACTC
CCGATCTTATGGGGTTGGCTCCGGGCGCAA|CTGCCAAAAATCGACCATGATGAAGAGTAG
CTGCCAAAAATCGACCATGATGAAGAGTAG|GACTTGTCGCGTACACCTGTATTAAAAGCC
ATGCCCTGTTTCATCCGCGGACCTGGGGTT|ACATCGTCAAAACGATCATTACCTAACCCC
ACCTGGGGTTTCTGCCAAAAATCGACCATG|ACCTAACCCCTGACTTGTCGCGTACACCTG
ACAACGTCGCGTTGCACTTCCCACTCAGCC|GCACCCTGCGGTAACACACTGGCGTACTCA
AGCGTTGCAGAGTGCCATACAGAGTGTGTT|TTGGGTCCGTCCCAAATGTTTGTAATGCAT
ACATAAATTCGCAGGGTCTAGCTACGGCAG|AATATTAGTTACGGAATTTCCATGAGCGGA
AGTGTGTTGCTCTATCGCATTTAAACTGGC|TAATGCATAGGTGCCCTGGGAGCATAAATC
TTAGTGAACGCCCCGTCCTTTGAATGGTGG|ATATTAGGGCAGAGATAGGTATAAAACAAA
CTCAATATTAGAAGGCCCTCAATATTAGTG|TAGTGGCGTACTCAAAGGCCCTCAATATTA
ATTCTTACCTGGTGTAGCTATACGAATGCT|ATATTAGTCTCTTTGCGGTAACTGATCTTG
CACGGCATCAATCCCACATTGATAATTTGA|AATGAACAACGTCGCGTTGCACTTCCCACT
CTCAAAGGCCCTCAATATTAGTGAACCACT|CAGAATATAAAGCCGCCCAATAATGCTCTG
TATGGATATACATTCTTACCTGGTGTAGCT|AAAGGCCCTCAATATTAGTCTCTTTGCGGT
GTGAACGCCCCGTCCTTTGAATGGTGGGTG|TTAGGGCAGAGATAGGTATAAAACAAACCC
TGCCAAAAATCGACCATGATGAAGAGTAGG|ACTTGTCGCGTACACCTGTATTAAAAGCCG
GCATCAATCCCACATTGATAATTTGACTAA|AACAACGTCGCGTTGCACTTCCCACTCAGC
ACAGCCTGTACTGGCGTACTCAACTGGCGT|GCCCTCAATACTGGCGTACTCAAAGGCCCT
GCGTACTCAAAGGCCCTCAATATTAGAGCT|AGAACGGTATACTTGTATCCCATTCAAGGC
TGGGGTTTCTGCCAAAAATCGACCATGATG|TAACCCCTGACTTGTCGCGTACACCTGTAT
TTAAACGACTGCTAAAGAAGCAATACGACC|GTAGCTATACGAATGCTATCAACGACTTTC
AAATCGACCATGATGAAGAGTAGGGAGACC|CGCGTACACCTGTATTAAAAGCCGGTACCA
ATTGAATGAACAACGTCGCGTTGCACTTCC|ATGGTGGGTGCACCCTGCGGTAACACACTG
CTTACCGATGAATTACCTACCAACACTTCT|TGCTGCCGTTTGGAGGGACAGATCGGGGTT
GGCTTAGTTCATTGGGTCCGTCCCAAATGT|AACTGGCGTACTCAAAGGCCCTCAATATTA
CCGACTGGCGTACTCAAAGGCCCTCAATAT|CATTGTAAGAACGGTATACTTGTATCCCAT
CCTTGCTCGGTGGTATGGATATACATTCTT|GACTGGCGTACTCAAAGGCCCTCAATATTA
TAGCGTTGCAGAGTGCCATACAGAGTGTGT|ATTGGGTCCGTCCCAAATGTTTGTAATGCA
TAAACGACTGCTAAAGAAGCAATACGACCT|TAGCTATACGAATGCTATCAACGACTTTCC
AATATTAGATTAGTGGCGTACTCAAAGGCC|CTGGCGTACTCAAAGGCCCTCAATATTAGA
CTGGCGTACTCAACTGGCGTACTCAAAGGC|CTGGCGTACTCAAAGGCCCTCAATATTAGA
CGTACTCAAAGGCCCTCAATATTAGAGCTA|GAACGGTATACTTGTATCCCATTCAAGGCA
TGCTGCCGTTTGGAGGGACAGATCGGGGTT|TTAGGTTACGAGCCACTGGCGTACTCAAAG
AGGCCCTCAATATTAGGTTACGAGCCACTG|AGACCAGACATCCGACTGGCGTACTCAAAG
TGTGCGCACTAATCCATGCAGATAGAGGCG|GCGGATTATACTGGCGTACTCAAAGGCCCT
TGCCCTGTTTCATCCGCGGACCTGGGGTTT|CATCGTCAAAACGATCATTACCTAACCCCT
AGGCCCTCAATATTAGATAACTTGCTGTTA|AGCTAGTTGGTGGCAAAACCCCCGCAGAAC
AAACAAACCCGATAGGTGCCGATCTTATGG|TCCGCGGACCTGGGGTTTCTGCCAAAAATC
ACGACCTTGGGTACTATTCCTCACCCCAAC|ACTTTCCACTACCCGCACGGCATCAATCCC
GTATGGATATACATTCTTACCTGGTGTAGC|CAAAGGCCCTCAATATTAGTCTCTTTGCGG
TAGTGTATCTTCGCCACTGGCGTACTCAAA|CTGGCGTACTCAAAGGCCCTCAATATTAGA
AATGTAAAGCTAGTGTATCTTCGCCACTGG|GGGAGACCGACTGGCGTACTCAAAGGCCCT
ACTGGCGTACTCAAAGGCCCTCAATATTAG|AAAGGCCCTCAATATTAGGCTTAGTTCATT
ATCAATCCCACATTGATAATTTGACTAAGT|CAACGTCGCGTTGCACTTCCCACTCAGCCT
ATATTAGGGCAGAGATAGGTATAAAACAAA|TTGCTGTTAAATGCCCTGTTTCATCCGCGG
AAAGGCCCTCAATACTGGCGTACTCAAAGG|CCGGGCGCAAATGTAAAGCTAGTGTATCTT
GGCCCTCAATATTAGATTAGTGGCGTACTC|TTCGCCACTGGCGTACTCAAAGGCCCTCAA
ATACATTCTTACCTGGTGTAGCTATACGAA|CTCAATATTAGTCTCTTTGCGGTAACTGAT
TTGGAGGGACAGATCGGGGTTCTTGGTAAC|GAGCCACTGGCGTACTCAAAGGCCCTCAAT
GAATGCTATCAACGACTTTCCACTACCCGC|GATCTTGTTGCTCATTGACCTTGCGATTGA
GGCCCTCAATATTAGATAACTTGCTGTTAA|GCTAGTTGGTGGCAAAACCCCCGCAGAACT
TATAAAACAAACCCGATAGGTGCCGATCTT|TTCATCCGCGGACCTGGGGTTTCTGCCAAA
CGCCACTGGCGTACTCAAAGGCCCTCAATA|AAAGGCCCTCAATATTAGAGCTAGTTGGTG
TGCACTTCCCACTCAGCCTGAACAGCCTGT|AACACACTGGCGTACTCAAAGGCCCTCAAT
TGGCGTACTCAAAGGCCCTCAATATTAGTC|TCAACTGGCGTACTCAAAGGCCCTCAATAT
ACCTTGGGTACTATTCCTCACCCCAACTGG|TTCCACTACCCGCACGGCATCAATCCCACA
CCCTCAATATTAGATTAGTGGCGTACTCAA|CGCCACTGGCGTACTCAAAGGCCCTCAATA
TCAAAGGCCCTCAATATTAGTCTCTTTGCG|CGTACTCAAAGGCCCTCAATATTAGAAGGC
CTGGCGTACTCAAAGGCCCTCAATATTAGT|CACATTGATAATTTGACTAAGTCAGCAGTT
GGTTGGCTCCGGGCGCAAATGTAAAGCTAG|GACCATGATGAAGAGTAGGGAGACCGACTG
TGAATGAACAACGTCGCGTTGCACTTCCCA|GGTGGGTGCACCCTGCGGTAACACACTGGC
TGCTATCAACGACTTTCCACTACCCGCACG|CTTGTTGCTCATTGACCTTGCGATTGAATG
AGAAGCAATACGACCTTGGGTACTATTCCT|CTATCAACGACTTTCCACTACCCGCACGGC
GCGTACTCAAAGGCCCTCAATATTAGTGAA|TACGGCAGAATATAAAGCCGCCCAATAATG
AGTCTCTTTGCGGTAACTGATCTTGTTGCT|ATATTAGAAGGCCCTCAATATTAGTGAACG
GGCGTACTCAAAGGCCCTCAATATTAGAGA|ATCCCTTAAAATAGCCCTCTTAAACGACTG
GGTATGGATATACATTCTTACCTGGTGTAG|TCAAAGGCCCTCAATATTAGTCTCTTTGCG
ATATTAGCGTTGCAGAGTGCCATACAGAGT|GTTCATTGGGTCCGTCCCAAATGTTTGTAA
CGCAAATGTAAAGCTAGTGTATCTTCGCCA|AGTAGGGAGACCGACTGGCGTACTCAAAGG
TACCTACCAACACTTCTGAATGCTTTATCG|AGGGACAGATCGGGGTTCTTGGTAACGTGG
TGGGAGCATAAATCCCTTAAAATAGCCCTC|CGGTGGTATGGATATACATTCTTACCTGGT
CTTGCTCGGTGGTATGGATATACATTCTTA|ACTGGCGTACTCAAAGGCCCTCAATATTAG
ATTAGTGAACCACTTACCGATGAATTACCT|CCAATAATGCTCTGCTGCCGTTTGGAGGGA
CGAGGACTGGCGTACTCAAAGGCCCTCAAT|GGCGTACTCAACTGGCGTACTCAAAGGCCC
GAACAACGTCGCGTTGCACTTCCCACTCAG|GTGCACCCTGCGGTAACACACTGGCGTACT
CCCTCAATATTAGGTTACGAGCCACTGGCG|CCAGACATCCGACTGGCGTACTCAAAGGCC
TCATCCGCGGACCTGGGGTTTCTGCCAAAA|AACGATCATTACCTAACCCCTGACTTGTCG
AGATAGAGGCGTACATAAATTCGCAGGGTC|TCAAAGGCCCTCAATATTAGTTACGGAATT
TCAATATTAGTGAACCACTTACCGATGAAT|GCCGCCCAATAATGCTCTGCTGCCGTTTGG
TTTCATCCGCGGACCTGGGGTTTCTGCCAA|AAAACGATCATTACCTAACCCCTGACTTGT
ATGCTTTATCGTTGTGCGCACTAATCCATG|TGGTAACGTGGTGCGGATTATACTGGCGTA
TGCTAAAGAAGCAATACGACCTTGGGTACT|CGAATGCTATCAACGACTTTCCACTACCCG
GCCCTCAATATTAGGGCAGAGATAGGTATA|AGATAACTTGCTGTTAAATGCCCTGTTTCA
ATGCATAGGTGCCCTGGGAGCATAAATCCC|CGACGACCCTTGCTCGGTGGTATGGATATA
AATATTAGTTACGGAATTTCCATGAGCGGA|CTATCGCATTTAAACTGGCGTACTCAAAGG
GATAACTTGCTGTTAAATGCCCTGTTTCAT|AAACCCCCGCAGAACTACATCGTCAAAACG
CCAACCACTGGCGTACTCAAAGGCCCTCAA|AGGGTCTAGCTACGGCAGAATATAAAGCCG
CCGATAGGTGCCGATCTTATGGGGTTGGCT|CCTGGGGTTTCTGCCAAAAATCGACCATGA
GTAACACACTGGCGTACTCAAAGGCCCTCA|CGATCTTATGGGGTTGGCTCCGGGCGCAAA
TGAATGCTTTATCGTTGTGCGCACTAATCC|TCTTGGTAACGTGGTGCGGATTATACTGGC
TCTATCGCATTTAAACTGGCGTACTCAAAG|GTGCCCTGGGAGCATAAATCCCTTAAAATA
CTCATTGACCTTGCGATTGAATGAACAACG|CGCCCCGTCCTTTGAATGGTGGGTGCACCC
GCGTACTCAAAGGCCCTCAATATTAGAAGG|CCCTCAATATTAGATTAGTGGCGTACTCAA
GTACTCAAAGGCCCTCAATATTAGAAGGCC|CTCAATATTAGATTAGTGGCGTACTCAAAG
CACTGGCGTACTCAAAGGCCCTCAATATTA|GGCCCTCAATATTAGAGCTAGTTGGTGGCA
TACGAATGCTATCAACGACTTTCCACTACC|ACTGATCTTGTTGCTCATTGACCTTGCGAT
TAGTTCATTGGGTCCGTCCCAAATGTTTGT|GGCGTACTCAAAGGCCCTCAATATTAGTCG
CATACAGAGTGTGTTGCTCTATCGCATTTA|ATGTTTGTAATGCATAGGTGCCCTGGGAGC
CTATTCCTCACCCCAACTGGCGTACTCAAA|CGCACGGCATCAATCCCACATTGATAATTT
GCCCTCTTAAACGACTGCTAAAGAAGCAAT|CCTGGTGTAGCTATACGAATGCTATCAACG
AAGGCCCTCAATATTAGATTAGTGGCGTAC|TCTTCGCCACTGGCGTACTCAAAGGCCCTC
CCCTCAATATTAGAGACCAGACATCCGACT|CCCTCTTAAACGACTGCTAAAGAAGCAATA
GGGTACTATTCCTCACCCCAACTGGCGTAC|CTACCCGCACGGCATCAATCCCACATTGAT
TAAGTCAGCAGTTTTCAGACGAGGACTGGC|AGCCTGAACAGCCTGTACTGGCGTACTCAA
TCCATGAGCGGACTGGCGTACTCAAAGGCC|CGTACTCAAAGGCCCTCAATATTAGAGACC
GACTGGCGTACTCAAAGGCCCTCAATATTA|TTGTAAGAACGGTATACTTGTATCCCATTC
AGTGTATCTTCGCCACTGGCGTACTCAAAG|TGGCGTACTCAAAGGCCCTCAATATTAGAG
CTTTGAATGGTGGGTGCACCCTGCGGTAAC|GGTATAAAACAAACCCGATAGGTGCCGATC
GTCTAGCTACGGCAGAATATAAAGCCGCCC|ATTTCCATGAGCGGACTGGCGTACTCAAAG
GAATTTCCATGAGCGGACTGGCGTACTCAA|ACTGGCGTACTCAAAGGCCCTCAATATTAG
TGCTCATTGACCTTGCGATTGAATGAACAA|AACGCCCCGTCCTTTGAATGGTGGGTGCAC
TACTCAACTGGCGTACTCAAAGGCCCTCAA|TACTCAAAGGCCCTCAATATTAGATTAGTG
GTAAAGCTAGTGTATCTTCGCCACTGGCGT|AGACCGACTGGCGTACTCAAAGGCCCTCAA
ACTGGCGTACTCAAAGGCCCTCAATATTAG|TAGCTACGGCAGAATATAAAGCCGCCCAAT
AGGGAGACCGACTGGCGTACTCAAAGGCCC|CCGGTACCATTGTAAGAACGGTATACTTGT
GGGTTTCTGCCAAAAATCGACCATGATGAA|ACCCCTGACTTGTCGCGTACACCTGTATTA
ACTGGCGTACTCAAAGGCCCTCAATACTGG|ATGGGGTTGGCTCCGGGCGCAAATGTAAAG
ATTAGTGGCGTACTCAAAGGCCCTCAATAT|CTCAAAGGCCCTCAATATTAGATAACTTGC
ATTAGATTAGTGGCGTACTCAAAGGCCCTC|GCGTACTCAAAGGCCCTCAATATTAGATAA
TTAGATAACTTGCTGTTAAATGCCCTGTTT|GCAAAACCCCCGCAGAACTACATCGTCAAA
CCTGTACTGGCGTACTCAACTGGCGTACTC|TCAATACTGGCGTACTCAAAGGCCCTCAAT
CTCGGTGGTATGGATATACATTCTTACCTG|GCGTACTCAAAGGCCCTCAATATTAGTCTC
TATCGTTGTGCGCACTAATCCATGCAGATA|CGTGGTGCGGATTATACTGGCGTACTCAAA
GCACCCTGCGGTAACACACTGGCGTACTCA|CGATAGGTGCCGATCTTATGGGGTTGGCTC
CCCTCAATATTAGTGAACCACTTACCGATG|AAAGCCGCCCAATAATGCTCTGCTGCCGTT
AGCCTGTACTGGCGTACTCAACTGGCGTAC|CCTCAATACTGGCGTACTCAAAGGCCCTCA
ATAGGTGCCCTGGGAGCATAAATCCCTTAA|GACCCTTGCTCGGTGGTATGGATATACATT
TACTCAAAGGCCCTCAATATTAGGCTTAGT|CTTGGGTACTATTCCTCACCCCAACTGGCG
CCGCGGACCTGGGGTTTCTGCCAAAAATCG|ATCATTACCTAACCCCTGACTTGTCGCGTA
TAAACTGGCGTACTCAAAGGCCCTCAATAT|GCATAAATCCCTTAAAATAGCCCTCTTAAA
CGCCCCGTCCTTTGAATGGTGGGTGCACCC|GCAGAGATAGGTATAAAACAAACCCGATAG
AAGAAGCAATACGACCTTGGGTACTATTCC|GCTATCAACGACTTTCCACTACCCGCACGG
ACGAGGACTGGCGTACTCAAAGGCCCTCAA|TGGCGTACTCAACTGGCGTACTCAAAGGCC
TCAATATTAGAGACCAGACATCCGACTGGC|TCTTAAACGACTGCTAAAGAAGCAATACGA
CAGAGTGCCATACAGAGTGTGTTGCTCTAT|CGTCCCAAATGTTTGTAATGCATAGGTGCC
TTAAACTGGCGTACTCAAAGGCCCTCAATA|AGCATAAATCCCTTAAAATAGCCCTCTTAA
ACGAATGCTATCAACGACTTTCCACTACCC|CTGATCTTGTTGCTCATTGACCTTGCGATT
CTCAATATTAGGCTTAGTTCATTGGGTCCG|TCCTCACCCCAACTGGCGTACTCAAAGGCC
CGCAGGGTCTAGCTACGGCAGAATATAAAG|TACGGAATTTCCATGAGCGGACTGGCGTAC
CTCAAAGGCCCTCAATATTAGTCGTCGACG|TAATTTGACTAAGTCAGCAGTTTTCAGACG
TGGCGTACTCAAAGGCCCTCAATATTAGTG|GCTACGGCAGAATATAAAGCCGCCCAATAA
ATAAAACAAACCCGATAGGTGCCGATCTTA|TCATCCGCGGACCTGGGGTTTCTGCCAAAA
GTTGCTCATTGACCTTGCGATTGAATGAAC|TGAACGCCCCGTCCTTTGAATGGTGGGTGC
ATAGGTATAAAACAAACCCGATAGGTGCCG|CCTGTTTCATCCGCGGACCTGGGGTTTCTG
CACTCAGCCTGAACAGCCTGTACTGGCGTA|GCGTACTCAAAGGCCCTCAATACTGGCGTA
AATTCGCAGGGTCTAGCTACGGCAGAATAT|TAGTTACGGAATTTCCATGAGCGGACTGGC
AAGCCGCCCAATAATGCTCTGCTGCCGTTT|TACTCAAAGGCCCTCAATATTAGGTTACGA
ACAGAGTGTGTTGCTCTATCGCATTTAAAC|TTTGTAATGCATAGGTGCCCTGGGAGCATA
CGTCGACGACCCTTGCTCGGTGGTATGGAT|TTCAGACGAGGACTGGCGTACTCAAAGGCC
GCCCTCAATATTAGTCGTCGACGACCCTTG|ACTAAGTCAGCAGTTTTCAGACGAGGACTG
GGCTCCGGGCGCAAATGTAAAGCTAGTGTA|ATGATGAAGAGTAGGGAGACCGACTGGCGT
CACTGGCGTACTCAAAGGCCCTCAATATTA|CAAAGGCCCTCAATATTAGGCTTAGTTCAT
GCGTACTCAAAGGCCCTCAATACTGGCGTA|GGTTGGCTCCGGGCGCAAATGTAAAGCTAG
TTACCGATGAATTACCTACCAACACTTCTG|GCTGCCGTTTGGAGGGACAGATCGGGGTTC
AGTCAGCAGTTTTCAGACGAGGACTGGCGT|CCTGAACAGCCTGTACTGGCGTACTCAACT
CCCAAATGTTTGTAATGCATAGGTGCCCTG|TCAATATTAGTCGTCGACGACCCTTGCTCG
GGCGTACTCAAAGGCCCTCAATATTAGCGT|GGCCCTCAATATTAGGCTTAGTTCATTGGG
TCTTATGGGGTTGGCTCCGGGCGCAAATGT|CAAAAATCGACCATGATGAAGAGTAGGGAG
GCCCCGTCCTTTGAATGGTGGGTGCACCCT|CAGAGATAGGTATAAAACAAACCCGATAGG
AAACCCGATAGGTGCCGATCTTATGGGGTT|CGGACCTGGGGTTTCTGCCAAAAATCGACC
AGATCGGGGTTCTTGGTAACGTGGTGCGGA|CGTACTCAAAGGCCCTCAATATTAGCGTTG
ACTCAAAGGCCCTCAATACTGGCGTACTCA|GGCTCCGGGCGCAAATGTAAAGCTAGTGTA
TTGTAATGCATAGGTGCCCTGGGAGCATAA|GTCGTCGACGACCCTTGCTCGGTGGTATGG
AGCCCTCTTAAACGACTGCTAAAGAAGCAA|ACCTGGTGTAGCTATACGAATGCTATCAAC
CTTAAACGACTGCTAAAGAAGCAATACGAC|TGTAGCTATACGAATGCTATCAACGACTTT
TATCTTCGCCACTGGCGTACTCAAAGGCCC|GTACTCAAAGGCCCTCAATATTAGAGCTAG
AATACTGGCGTACTCAAAGGCCCTCAATAT|ATGTAAAGCTAGTGTATCTTCGCCACTGGC
GACTGGCGTACTCAAAGGCCCTCAATATTA|TACTCAACTGGCGTACTCAAAGGCCCTCAA
AACTGATCTTGTTGCTCATTGACCTTGCGA|TCAATATTAGTGAACGCCCCGTCCTTTGAA
CCGTCCCAAATGTTTGTAATGCATAGGTGC|GCCCTCAATATTAGTCGTCGACGACCCTTG
GTATAAAACAAACCCGATAGGTGCCGATCT|TTTCATCCGCGGACCTGGGGTTTCTGCCAA
CATCCGCGGACCTGGGGTTTCTGCCAAAAA|ACGATCATTACCTAACCCCTGACTTGTCGC
GGTTCTTGGTAACGTGGTGCGGATTATACT|AAAGGCCCTCAATATTAGCGTTGCAGAGTG
AAGGCCCTCAATATTAGTGAACCACTTACC|ATATAAAGCCGCCCAATAATGCTCTGCTGC
CCACTGGCGTACTCAAAGGCCCTCAATATT|TCTAGCTACGGCAGAATATAAAGCCGCCCA
CTGGCGTACTCAAAGGCCCTCAATATTAGA|GTAAGAACGGTATACTTGTATCCCATTCAA
TAACGTGGTGCGGATTATACTGGCGTACTC|CAATATTAGCGTTGCAGAGTGCCATACAGA
TATTAGGGCAGAGATAGGTATAAAACAAAC|TGCTGTTAAATGCCCTGTTTCATCCGCGGA
AAAGCCGCCCAATAATGCTCTGCTGCCGTT|GTACTCAAAGGCCCTCAATATTAGGTTACG
GGTAACTGATCTTGTTGCTCATTGACCTTG|CCCTCAATATTAGTGAACGCCCCGTCCTTT
AACAGCCTGTACTGGCGTACTCAACTGGCG|GGCCCTCAATACTGGCGTACTCAAAGGCCC
GCGCACTAATCCATGCAGATAGAGGCGTAC|GATTATACTGGCGTACTCAAAGGCCCTCAA
AAGGCCCTCAATATTAGTTACGGAATTTCC|TGTGTTGCTCTATCGCATTTAAACTGGCGT
CCTTGCGATTGAATGAACAACGTCGCGTTG|CCTTTGAATGGTGGGTGCACCCTGCGGTAA
ATTCCTCACCCCAACTGGCGTACTCAAAGG|CACGGCATCAATCCCACATTGATAATTTGA
GGCGTACTCAAAGGCCCTCAATATTAGATT|AGCTAGTGTATCTTCGCCACTGGCGTACTC
TTGCTCTATCGCATTTAAACTGGCGTACTC|ATAGGTGCCCTGGGAGCATAAATCCCTTAA
CAATCCCACATTGATAATTTGACTAAGTCA|ACGTCGCGTTGCACTTCCCACTCAGCCTGA
TCCGGGCGCAAATGTAAAGCTAGTGTATCT|ATGAAGAGTAGGGAGACCGACTGGCGTACT
TCAGCAGTTTTCAGACGAGGACTGGCGTAC|TGAACAGCCTGTACTGGCGTACTCAACTGG
GAGTAGGGAGACCGACTGGCGTACTCAAAG|AAAGCCGGTACCATTGTAAGAACGGTATAC
ATATTAGTGAACCACTTACCGATGAATTAC|GCCCAATAATGCTCTGCTGCCGTTTGGAGG
ACGGCATCAATCCCACATTGATAATTTGAC|ATGAACAACGTCGCGTTGCACTTCCCACTC
TCTCTTTGCGGTAACTGATCTTGTTGCTCA|ATTAGAAGGCCCTCAATATTAGTGAACGCC
AGGGCAGAGATAGGTATAAAACAAACCCGA|GTTAAATGCCCTGTTTCATCCGCGGACCTG
TACGGCAGAATATAAAGCCGCCCAATAATG|TGAGCGGACTGGCGTACTCAAAGGCCCTCA
CACTTACCGATGAATTACCTACCAACACTT|TCTGCTGCCGTTTGGAGGGACAGATCGGGG
CGTACTCAAAGGCCCTCAATATTAGTCGTC|TTGATAATTTGACTAAGTCAGCAGTTTTCA
GGTCCGTCCCAAATGTTTGTAATGCATAGG|AAGGCCCTCAATATTAGTCGTCGACGACCC
AGGCCCTCAATACTGGCGTACTCAAAGGCC|GGGCGCAAATGTAAAGCTAGTGTATCTTCG
ACTCAGCCTGAACAGCCTGTACTGGCGTAC|CGTACTCAAAGGCCCTCAATACTGGCGTAC
CGTTTGGAGGGACAGATCGGGGTTCTTGGT|TACGAGCCACTGGCGTACTCAAAGGCCCTC
ACTGGCGTACTCAAAGGCCCTCAATATTAG|TAAAGCTAGTGTATCTTCGCCACTGGCGTA
CGGATTATACTGGCGTACTCAAAGGCCCTC|GTTGCAGAGTGCCATACAGAGTGTGTTGCT
AAGCAATACGACCTTGGGTACTATTCCTCA|ATCAACGACTTTCCACTACCCGCACGGCAT
CAATATTAGTGAACGCCCCGTCCTTTGAAT|CCTCAATATTAGGGCAGAGATAGGTATAAA
CATGCAGATAGAGGCGTACATAAATTCGCA|CGTACTCAAAGGCCCTCAATATTAGTTACG
AATCCCACATTGATAATTTGACTAAGTCAG|CGTCGCGTTGCACTTCCCACTCAGCCTGAA
CCAAATGTTTGTAATGCATAGGTGCCCTGG|CAATATTAGTCGTCGACGACCCTTGCTCGG
CATTGATAATTTGACTAAGTCAGCAGTTTT|TTGCACTTCCCACTCAGCCTGAACAGCCTG
AATATTAGAGACCAGACATCCGACTGGCGT|TTAAACGACTGCTAAAGAAGCAATACGACC
CATGATGAAGAGTAGGGAGACCGACTGGCG|CCTGTATTAAAAGCCGGTACCATTGTAAGA
AATATTAGATAACTTGCTGTTAAATGCCCT|GGTGGCAAAACCCCCGCAGAACTACATCGT
ATAGCCCTCTTAAACGACTGCTAAAGAAGC|TTACCTGGTGTAGCTATACGAATGCTATCA
TACTCAAAGGCCCTCAATATTAGTTACGGA|ACAGAGTGTGTTGCTCTATCGCATTTAAAC
ATAATTTGACTAAGTCAGCAGTTTTCAGAC|CTTCCCACTCAGCCTGAACAGCCTGTACTG
TTAGTTCATTGGGTCCGTCCCAAATGTTTG|TGGCGTACTCAAAGGCCCTCAATATTAGTC
ATCGGGGTTCTTGGTAACGTGGTGCGGATT|TACTCAAAGGCCCTCAATATTAGCGTTGCA
CAATATTAGGCTTAGTTCATTGGGTCCGTC|CTCACCCCAACTGGCGTACTCAAAGGCCCT
TACTCAAAGGCCCTCAATATTAGGTTACGA|ATATTAGAGACCAGACATCCGACTGGCGTA
GACTGGCGTACTCAAAGGCCCTCAATATTA|GGCCCTCAATATTAGAGACCAGACATCCGA
ACTCAAAGGCCCTCAATATTAGAAGGCCCT|CAATATTAGATTAGTGGCGTACTCAAAGGC
AAGGCCCTCAATATTAGGCTTAGTTCATTG|TACTATTCCTCACCCCAACTGGCGTACTCA
GCCCTCAATACTGGCGTACTCAAAGGCCCT|GCGCAAATGTAAAGCTAGTGTATCTTCGCC
TCAATATTAGCGTTGCAGAGTGCCATACAG|TTAGTTCATTGGGTCCGTCCCAAATGTTTG
AATATTAGGGCAGAGATAGGTATAAAACAA|CTTGCTGTTAAATGCCCTGTTTCATCCGCG
CTGTTTCATCCGCGGACCTGGGGTTTCTGC|GTCAAAACGATCATTACCTAACCCCTGACT
GCGTACTCAAAGGCCCTCAATATTAGTCGT|ATTGATAATTTGACTAAGTCAGCAGTTTTC
GTACTCAAAGGCCCTCAATATTAGCGTTGC|CCTCAATATTAGGCTTAGTTCATTGGGTCC
ATGCTATCAACGACTTTCCACTACCCGCAC|TCTTGTTGCTCATTGACCTTGCGATTGAAT
ATTGATAATTTGACTAAGTCAGCAGTTTTC|TGCACTTCCCACTCAGCCTGAACAGCCTGT
ACATTCTTACCTGGTGTAGCTATACGAATG|CAATATTAGTCTCTTTGCGGTAACTGATCT
TGGTGGGTGCACCCTGCGGTAACACACTGG|AACAAACCCGATAGGTGCCGATCTTATGGG
ATGGTGGGTGCACCCTGCGGTAACACACTG|AAACAAACCCGATAGGTGCCGATCTTATGG
ATCAACGACTTTCCACTACCCGCACGGCAT|TTGCTCATTGACCTTGCGATTGAATGAACA
TACATAAATTCGCAGGGTCTAGCTACGGCA|CAATATTAGTTACGGAATTTCCATGAGCGG
TTGACTAAGTCAGCAGTTTTCAGACGAGGA|CACTCAGCCTGAACAGCCTGTACTGGCGTA
CGAATGCTATCAACGACTTTCCACTACCCG|TGATCTTGTTGCTCATTGACCTTGCGATTG
CAGAATATAAAGCCGCCCAATAATGCTCTG|GGACTGGCGTACTCAAAGGCCCTCAATATT
CCCTCAATATTAGAAGGCCCTCAATATTAG|ATTAGTGGCGTACTCAAAGGCCCTCAATAT
TAGTGAACGCCCCGTCCTTTGAATGGTGGG|TATTAGGGCAGAGATAGGTATAAAACAAAC
AGTGAACCACTTACCGATGAATTACCTACC|ATAATGCTCTGCTGCCGTTTGGAGGGACAG
GGTGTAGCTATACGAATGCTATCAACGACT|CTTTGCGGTAACTGATCTTGTTGCTCATTG
TTAGGCTTAGTTCATTGGGTCCGTCCCAAA|CCCAACTGGCGTACTCAAAGGCCCTCAATA
ACACACTGGCGTACTCAAAGGCCCTCAATA|TCTTATGGGGTTGGCTCCGGGCGCAAATGT
GTCGACGACCCTTGCTCGGTGGTATGGATA|TCAGACGAGGACTGGCGTACTCAAAGGCCC
TCAATACTGGCGTACTCAAAGGCCCTCAAT|AAATGTAAAGCTAGTGTATCTTCGCCACTG
TATACGAATGCTATCAACGACTTTCCACTA|TAACTGATCTTGTTGCTCATTGACCTTGCG
AGTGAACGCCCCGTCCTTTGAATGGTGGGT|ATTAGGGCAGAGATAGGTATAAAACAAACC
GTCTCTTTGCGGTAACTGATCTTGTTGCTC|TATTAGAAGGCCCTCAATATTAGTGAACGC
GCGTTGCACTTCCCACTCAGCCTGAACAGC|CGGTAACACACTGGCGTACTCAAAGGCCCT
GTACATAAATTCGCAGGGTCTAGCTACGGC|TCAATATTAGTTACGGAATTTCCATGAGCG
ATCCGCGGACCTGGGGTTTCTGCCAAAAAT|CGATCATTACCTAACCCCTGACTTGTCGCG
GTGCCGATCTTATGGGGTTGGCTCCGGGCG|TTTCTGCCAAAAATCGACCATGATGAAGAG
CTGGCGTACTCAAAGGCCCTCAATATTAGG|TACGACCTTGGGTACTATTCCTCACCCCAA
TTGGCTCCGGGCGCAAATGTAAAGCTAGTG|CCATGATGAAGAGTAGGGAGACCGACTGGC
TTACCTACCAACACTTCTGAATGCTTTATC|GAGGGACAGATCGGGGTTCTTGGTAACGTG
TATGGGGTTGGCTCCGGGCGCAAATGTAAA|AAATCGACCATGATGAAGAGTAGGGAGACC
CTCAATATTAGCGTTGCAGAGTGCCATACA|CTTAGTTCATTGGGTCCGTCCCAAATGTTT
AACTGGCGTACTCAAAGGCCCTCAATATTA|ATAAATCCCTTAAAATAGCCCTCTTAAACG
GACCTTGGGTACTATTCCTCACCCCAACTG|TTTCCACTACCCGCACGGCATCAATCCCAC
TTAAAATAGCCCTCTTAAACGACTGCTAAA|CATTCTTACCTGGTGTAGCTATACGAATGC
GTTCTTGGTAACGTGGTGCGGATTATACTG|AAGGCCCTCAATATTAGCGTTGCAGAGTGC
GTTGCTCTATCGCATTTAAACTGGCGTACT|CATAGGTGCCCTGGGAGCATAAATCCCTTA
CAAAGGCCCTCAATATTAGATTAGTGGCGT|TATCTTCGCCACTGGCGTACTCAAAGGCCC
CCCGTCCTTTGAATGGTGGGTGCACCCTGC|GAGATAGGTATAAAACAAACCCGATAGGTG
ACCAGACATCCGACTGGCGTACTCAAAGGC|GCTAAAGAAGCAATACGACCTTGGGTACTA
GTTAAATGCCCTGTTTCATCCGCGGACCTG|GAACTACATCGTCAAAACGATCATTACCTA
GCCCTGGGAGCATAAATCCCTTAAAATAGC|TGCTCGGTGGTATGGATATACATTCTTACC
AAAATCGACCATGATGAAGAGTAGGGAGAC|TCGCGTACACCTGTATTAAAAGCCGGTACC
TCAGACGAGGACTGGCGTACTCAAAGGCCC|GTACTGGCGTACTCAACTGGCGTACTCAAA
AGGCCCTCAATATTAGGCTTAGTTCATTGG|ACTATTCCTCACCCCAACTGGCGTACTCAA
ACTCAAAGGCCCTCAATATTAGTGAACCAC|GCAGAATATAAAGCCGCCCAATAATGCTCT
GCCGATCTTATGGGGTTGGCTCCGGGCGCA|TCTGCCAAAAATCGACCATGATGAAGAGTA
TTCATTGGGTCCGTCCCAAATGTTTGTAAT|GTACTCAAAGGCCCTCAATATTAGTCGTCG
TGTTTCATCCGCGGACCTGGGGTTTCTGCC|TCAAAACGATCATTACCTAACCCCTGACTT
CGACCTTGGGTACTATTCCTCACCCCAACT|CTTTCCACTACCCGCACGGCATCAATCCCA
ACTGGCGTACTCAACTGGCGTACTCAAAGG|ACTGGCGTACTCAAAGGCCCTCAATATTAG
TCGACGACCCTTGCTCGGTGGTATGGATAT|CAGACGAGGACTGGCGTACTCAAAGGCCCT
TACGACCTTGGGTACTATTCCTCACCCCAA|GACTTTCCACTACCCGCACGGCATCAATCC
TGGGTGCACCCTGCGGTAACACACTGGCGT|AAACCCGATAGGTGCCGATCTTATGGGGTT
CTGGCGTACTCAAAGGCCCTCAATATTAGT|CTCAACTGGCGTACTCAAAGGCCCTCAATA
ATGGGGTTGGCTCCGGGCGCAAATGTAAAG|AATCGACCATGATGAAGAGTAGGGAGACCG
GGCGTACTCAAAGGCCCTCAATATTAGTTA|CCATACAGAGTGTGTTGCTCTATCGCATTT
TAAATCCCTTAAAATAGCCCTCTTAAACGA|TGGATATACATTCTTACCTGGTGTAGCTAT
CGTACTCAAAGGCCCTCAATATTAGTGAAC|ACGGCAGAATATAAAGCCGCCCAATAATGC
CAGAGTGTGTTGCTCTATCGCATTTAAACT|TTGTAATGCATAGGTGCCCTGGGAGCATAA
AACGTCGCGTTGCACTTCCCACTCAGCCTG|ACCCTGCGGTAACACACTGGCGTACTCAAA
GTTTGTAATGCATAGGTGCCCTGGGAGCAT|TAGTCGTCGACGACCCTTGCTCGGTGGTAT
TTTAAACTGGCGTACTCAAAGGCCCTCAAT|GAGCATAAATCCCTTAAAATAGCCCTCTTA
CCCTTAAAATAGCCCTCTTAAACGACTGCT|ATACATTCTTACCTGGTGTAGCTATACGAA
AACGTGGTGCGGATTATACTGGCGTACTCA|AATATTAGCGTTGCAGAGTGCCATACAGAG
GACAGATCGGGGTTCTTGGTAACGTGGTGC|TGGCGTACTCAAAGGCCCTCAATATTAGCG
TGGCGTACTCAAAGGCCCTCAATATTAGAG|TAAGAACGGTATACTTGTATCCCATTCAAG
CAATATTAGTCGTCGACGACCCTTGCTCGG|GTCAGCAGTTTTCAGACGAGGACTGGCGTA
AATGCATAGGTGCCCTGGGAGCATAAATCC|TCGACGACCCTTGCTCGGTGGTATGGATAT
TTAGGTTACGAGCCACTGGCGTACTCAAAG|CGACTGGCGTACTCAAAGGCCCTCAATATT
CACATTGATAATTTGACTAAGTCAGCAGTT|CGTTGCACTTCCCACTCAGCCTGAACAGCC
TGTACTGGCGTACTCAACTGGCGTACTCAA|AATACTGGCGTACTCAAAGGCCCTCAATAT
GCCAACCACTGGCGTACTCAAAGGCCCTCA|CAGGGTCTAGCTACGGCAGAATATAAAGCC
CGTACTCAAAGGCCCTCAATATTAGGCTTA|ACCTTGGGTACTATTCCTCACCCCAACTGG
GGACTGGCGTACTCAAAGGCCCTCAATATT|GTACTCAACTGGCGTACTCAAAGGCCCTCA
AATATTAGGCTTAGTTCATTGGGTCCGTCC|TCACCCCAACTGGCGTACTCAAAGGCCCTC
GACTGGCGTACTCAAAGGCCCTCAATATTA|AATACGACCTTGGGTACTATTCCTCACCCC
CGCCCAATAATGCTCTGCTGCCGTTTGGAG|CAAAGGCCCTCAATATTAGGTTACGAGCCA
CCTCAATATTAGTTACGGAATTTCCATGAG|TGCTCTATCGCATTTAAACTGGCGTACTCA
GTACTCAAAGGCCCTCAATATTAGATTAGT|TAGTGTATCTTCGCCACTGGCGTACTCAAA
CTGCTGCCGTTTGGAGGGACAGATCGGGGT|ATTAGGTTACGAGCCACTGGCGTACTCAAA
ATTAGGTTACGAGCCACTGGCGTACTCAAA|CCGACTGGCGTACTCAAAGGCCCTCAATAT
GGTAACGTGGTGCGGATTATACTGGCGTAC|CTCAATATTAGCGTTGCAGAGTGCCATACA
TCTTACCTGGTGTAGCTATACGAATGCTAT|ATTAGTCTCTTTGCGGTAACTGATCTTGTT
CCCCAACTGGCGTACTCAAAGGCCCTCAAT|CAATCCCACATTGATAATTTGACTAAGTCA
TGAATTACCTACCAACACTTCTGAATGCTT|TTTGGAGGGACAGATCGGGGTTCTTGGTAA
TAAAACAAACCCGATAGGTGCCGATCTTAT|CATCCGCGGACCTGGGGTTTCTGCCAAAAA
TCAATATTAGGTTACGAGCCACTGGCGTAC|GACATCCGACTGGCGTACTCAAAGGCCCTC
CGACTGCTAAAGAAGCAATACGACCTTGGG|TATACGAATGCTATCAACGACTTTCCACTA
TAGGCTTAGTTCATTGGGTCCGTCCCAAAT|CCAACTGGCGTACTCAAAGGCCCTCAATAT
CTGGCGTACTCAAAGGCCCTCAATATTAGA|CCCTCAATATTAGAGCTAGTTGGTGGCAAA
TTGGGTCCGTCCCAAATGTTTGTAATGCAT|TCAAAGGCCCTCAATATTAGTCGTCGACGA
ATCTTCGCCACTGGCGTACTCAAAGGCCCT|TACTCAAAGGCCCTCAATATTAGAGCTAGT
CTCAATATTAGGTTACGAGCCACTGGCGTA|AGACATCCGACTGGCGTACTCAAAGGCCCT
GGGAGCATAAATCCCTTAAAATAGCCCTCT|GGTGGTATGGATATACATTCTTACCTGGTG
GCTCGGTGGTATGGATATACATTCTTACCT|GGCGTACTCAAAGGCCCTCAATATTAGTCT
GCTATACGAATGCTATCAACGACTTTCCAC|GGTAACTGATCTTGTTGCTCATTGACCTTG
GCAAATGTAAAGCTAGTGTATCTTCGCCAC|GTAGGGAGACCGACTGGCGTACTCAAAGGC
TTCCTCACCCCAACTGGCGTACTCAAAGGC|ACGGCATCAATCCCACATTGATAATTTGAC
AGATAACTTGCTGTTAAATGCCCTGTTTCA|AAAACCCCCGCAGAACTACATCGTCAAAAC
CTGTTAAATGCCCTGTTTCATCCGCGGACC|CAGAACTACATCGTCAAAACGATCATTACC
TTAGGGCAGAGATAGGTATAAAACAAACCC|CTGTTAAATGCCCTGTTTCATCCGCGGACC
ACGGCAGAATATAAAGCCGCCCAATAATGC|GAGCGGACTGGCGTACTCAAAGGCCCTCAA
ACATTGATAATTTGACTAAGTCAGCAGTTT|GTTGCACTTCCCACTCAGCCTGAACAGCCT
ACAAACCCGATAGGTGCCGATCTTATGGGG|CGCGGACCTGGGGTTTCTGCCAAAAATCGA
TCTTTGCGGTAACTGATCTTGTTGCTCATT|TAGAAGGCCCTCAATATTAGTGAACGCCCC
GTGTATCTTCGCCACTGGCGTACTCAAAGG|GGCGTACTCAAAGGCCCTCAATATTAGAGC
GAAGCAATACGACCTTGGGTACTATTCCTC|TATCAACGACTTTCCACTACCCGCACGGCA
AAAGGCCCTCAATATTAGCGTTGCAGAGTG|TATTAGGCTTAGTTCATTGGGTCCGTCCCA
CTCAAAGGCCCTCAATATTAGCGTTGCAGA|CAATATTAGGCTTAGTTCATTGGGTCCGTC
GGCGTACTCAAAGGCCCTCAATATTAGTCT|CAACTGGCGTACTCAAAGGCCCTCAATATT
ATTAGTCTCTTTGCGGTAACTGATCTTGTT|TCAATATTAGAAGGCCCTCAATATTAGTGA
GAATATAAAGCCGCCCAATAATGCTCTGCT|ACTGGCGTACTCAAAGGCCCTCAATATTAG
TGGCGTACTCAAAGGCCCTCAATATTAGTT|GCCATACAGAGTGTGTTGCTCTATCGCATT
GAATGGTGGGTGCACCCTGCGGTAACACAC|TAAAACAAACCCGATAGGTGCCGATCTTAT
CCTCAATATTAGGGCAGAGATAGGTATAAA|ATAACTTGCTGTTAAATGCCCTGTTTCATC
GATATACATTCTTACCTGGTGTAGCTATAC|GCCCTCAATATTAGTCTCTTTGCGGTAACT
TGCTCTGCTGCCGTTTGGAGGGACAGATCG|CAATATTAGGTTACGAGCCACTGGCGTACT
AGGCCCTCAATATTAGCGTTGCAGAGTGCC|TTAGGCTTAGTTCATTGGGTCCGTCCCAAA
TGCGATTGAATGAACAACGTCGCGTTGCAC|TTGAATGGTGGGTGCACCCTGCGGTAACAC
ATTAGTCGTCGACGACCCTTGCTCGGTGGT|GCAGTTTTCAGACGAGGACTGGCGTACTCA
TATTAGGCTTAGTTCATTGGGTCCGTCCCA|ACCCCAACTGGCGTACTCAAAGGCCCTCAA
GATGAAGAGTAGGGAGACCGACTGGCGTAC|GTATTAAAAGCCGGTACCATTGTAAGAACG
ATGAGCGGACTGGCGTACTCAAAGGCCCTC|ACTCAAAGGCCCTCAATATTAGAGACCAGA
GGACCTGGGGTTTCTGCCAAAAATCGACCA|TTACCTAACCCCTGACTTGTCGCGTACACC
TATTAGCGTTGCAGAGTGCCATACAGAGTG|TTCATTGGGTCCGTCCCAAATGTTTGTAAT
TGAAGAGTAGGGAGACCGACTGGCGTACTC|ATTAAAAGCCGGTACCATTGTAAGAACGGT
TTCTGAATGCTTTATCGTTGTGCGCACTAA|GGTTCTTGGTAACGTGGTGCGGATTATACT
TGGTATGGATATACATTCTTACCTGGTGTA|CTCAAAGGCCCTCAATATTAGTCTCTTTGC
CCGACTGGCGTACTCAAAGGCCCTCAATAT|GCAATACGACCTTGGGTACTATTCCTCACC
TAAAGCTAGTGTATCTTCGCCACTGGCGTA|GACCGACTGGCGTACTCAAAGGCCCTCAAT
CTTGTTGCTCATTGACCTTGCGATTGAATG|TAGTGAACGCCCCGTCCTTTGAATGGTGGG
AAAGGCCCTCAATATTAGAAGGCCCTCAAT|ATTAGATTAGTGGCGTACTCAAAGGCCCTC
CTATACGAATGCTATCAACGACTTTCCACT|GTAACTGATCTTGTTGCTCATTGACCTTGC
TAGGTGCCGATCTTATGGGGTTGGCTCCGG|GGGTTTCTGCCAAAAATCGACCATGATGAA
TGCACCCTGCGGTAACACACTGGCGTACTC|CCGATAGGTGCCGATCTTATGGGGTTGGCT
TCCATGCAGATAGAGGCGTACATAAATTCG|GGCGTACTCAAAGGCCCTCAATATTAGTTA
GGCCCTCAATATTAGTGAACCACTTACCGA|ATAAAGCCGCCCAATAATGCTCTGCTGCCG
GCGATTGAATGAACAACGTCGCGTTGCACT|TGAATGGTGGGTGCACCCTGCGGTAACACA
GTGGTATGGATATACATTCTTACCTGGTGT|ACTCAAAGGCCCTCAATATTAGTCTCTTTG
ATATTAGAGACCAGACATCCGACTGGCGTA|TAAACGACTGCTAAAGAAGCAATACGACCT
CGATGAATTACCTACCAACACTTCTGAATG|CCGTTTGGAGGGACAGATCGGGGTTCTTGG
CCCAATAATGCTCTGCTGCCGTTTGGAGGG|AAGGCCCTCAATATTAGGTTACGAGCCACT
ACTGATCTTGTTGCTCATTGACCTTGCGAT|CAATATTAGTGAACGCCCCGTCCTTTGAAT
GGCGTACTCAAAGGCCCTCAATATTAGGTT|CTCAATATTAGAGACCAGACATCCGACTGG
ATATTAGGTTACGAGCCACTGGCGTACTCA|ATCCGACTGGCGTACTCAAAGGCCCTCAAT
GAACGCCCCGTCCTTTGAATGGTGGGTGCA|AGGGCAGAGATAGGTATAAAACAAACCCGA
CGACCCTTGCTCGGTGGTATGGATATACAT|CGAGGACTGGCGTACTCAAAGGCCCTCAAT
CAACGTCGCGTTGCACTTCCCACTCAGCCT|CACCCTGCGGTAACACACTGGCGTACTCAA
TCAATATTAGTGAACGCCCCGTCCTTTGAA|CCCTCAATATTAGGGCAGAGATAGGTATAA
CACTGGCGTACTCAAAGGCCCTCAATATTA|CTAGCTACGGCAGAATATAAAGCCGCCCAA
CTGGCGTACTCAAAGGCCCTCAATATTAGA|AAATCCCTTAAAATAGCCCTCTTAAACGAC
AGACGAGGACTGGCGTACTCAAAGGCCCTC|ACTGGCGTACTCAACTGGCGTACTCAAAGG
CTTTGCGGTAACTGATCTTGTTGCTCATTG|AGAAGGCCCTCAATATTAGTGAACGCCCCG
CAGACATCCGACTGGCGTACTCAAAGGCCC|TAAAGAAGCAATACGACCTTGGGTACTATT
TAATGCATAGGTGCCCTGGGAGCATAAATC|GTCGACGACCCTTGCTCGGTGGTATGGATA
TCAATATTAGGGCAGAGATAGGTATAAAAC|AACTTGCTGTTAAATGCCCTGTTTCATCCG
CTTAAAATAGCCCTCTTAAACGACTGCTAA|ACATTCTTACCTGGTGTAGCTATACGAATG
GCACGGCATCAATCCCACATTGATAATTTG|GAATGAACAACGTCGCGTTGCACTTCCCAC
AGTTTTCAGACGAGGACTGGCGTACTCAAA|AGCCTGTACTGGCGTACTCAACTGGCGTAC
AATATTAGCGTTGCAGAGTGCCATACAGAG|AGTTCATTGGGTCCGTCCCAAATGTTTGTA
CTCAATATTAGTCTCTTTGCGGTAACTGAT|AGGCCCTCAATATTAGAAGGCCCTCAATAT
TCAAAGGCCCTCAATATTAGATAACTTGCT|TTAGAGCTAGTTGGTGGCAAAACCCCCGCA
CCTCAATATTAGATTAGTGGCGTACTCAAA|GCCACTGGCGTACTCAAAGGCCCTCAATAT
AAAACAAACCCGATAGGTGCCGATCTTATG|ATCCGCGGACCTGGGGTTTCTGCCAAAAAT
AAAGAAGCAATACGACCTTGGGTACTATTC|TGCTATCAACGACTTTCCACTACCCGCACG
AACACTTCTGAATGCTTTATCGTTGTGCGC|ATCGGGGTTCTTGGTAACGTGGTGCGGATT
CCATACAGAGTGTGTTGCTCTATCGCATTT|AATGTTTGTAATGCATAGGTGCCCTGGGAG
GTGCGCACTAATCCATGCAGATAGAGGCGT|CGGATTATACTGGCGTACTCAAAGGCCCTC
CATTGACCTTGCGATTGAATGAACAACGTC|CCCCGTCCTTTGAATGGTGGGTGCACCCTG
GATAGAGGCGTACATAAATTCGCAGGGTCT|CAAAGGCCCTCAATATTAGTTACGGAATTT
TATTAGTCGTCGACGACCCTTGCTCGGTGG|AGCAGTTTTCAGACGAGGACTGGCGTACTC
TACTGGCGTACTCAAAGGCCCTCAATATTA|AGTGCCATACAGAGTGTGTTGCTCTATCGC
CCTCAATATTAGTGAACGCCCCGTCCTTTG|GGCCCTCAATATTAGGGCAGAGATAGGTAT
CCATGAGCGGACTGGCGTACTCAAAGGCCC|GTACTCAAAGGCCCTCAATATTAGAGACCA
AATAATGCTCTGCTGCCGTTTGGAGGGACA|GCCCTCAATATTAGGTTACGAGCCACTGGC
ACTTCTGAATGCTTTATCGTTGTGCGCACT|GGGGTTCTTGGTAACGTGGTGCGGATTATA
CTGGTGTAGCTATACGAATGCTATCAACGA|CTCTTTGCGGTAACTGATCTTGTTGCTCAT
CTTAGTTCATTGGGTCCGTCCCAAATGTTT|CTGGCGTACTCAAAGGCCCTCAATATTAGT
TACTCAAAGGCCCTCAATATTAGTCTCTTT|TGGCGTACTCAAAGGCCCTCAATATTAGAA
TACCTGGTGTAGCTATACGAATGCTATCAA|AGTCTCTTTGCGGTAACTGATCTTGTTGCT
CCTCAATATTAGAGACCAGACATCCGACTG|CCTCTTAAACGACTGCTAAAGAAGCAATAC
GGCGTACTCAAAGGCCCTCAATATTAGGGC|GGCCCTCAATATTAGATAACTTGCTGTTAA
AAATAGCCCTCTTAAACGACTGCTAAAGAA|TCTTACCTGGTGTAGCTATACGAATGCTAT
TCGGGGTTCTTGGTAACGTGGTGCGGATTA|ACTCAAAGGCCCTCAATATTAGCGTTGCAG
AAAGGCCCTCAATATTAGTTACGGAATTTC|GTGTGTTGCTCTATCGCATTTAAACTGGCG
CAATATTAGAAGGCCCTCAATATTAGTGAA|GTGGCGTACTCAAAGGCCCTCAATATTAGG
TATTCCTCACCCCAACTGGCGTACTCAAAG|GCACGGCATCAATCCCACATTGATAATTTG
CGTACTCAAAGGCCCTCAATATTAGATAAC|CAATATTAGAGCTAGTTGGTGGCAAAACCC
GTTGGCTCCGGGCGCAAATGTAAAGCTAGT|ACCATGATGAAGAGTAGGGAGACCGACTGG
AGCGGACTGGCGTACTCAAAGGCCCTCAAT|CAAAGGCCCTCAATATTAGAGACCAGACAT
TCAATATTAGTTACGGAATTTCCATGAGCG|CTCTATCGCATTTAAACTGGCGTACTCAAA
ATCTTGTTGCTCATTGACCTTGCGATTGAA|ATTAGTGAACGCCCCGTCCTTTGAATGGTG
GACTGCTAAAGAAGCAATACGACCTTGGGT|ATACGAATGCTATCAACGACTTTCCACTAC
AAGGCCCTCAATATTAGTGAACGCCCCGTC|TCAAAGGCCCTCAATATTAGGGCAGAGATA
ATTAGGGCAGAGATAGGTATAAAACAAACC|GCTGTTAAATGCCCTGTTTCATCCGCGGAC
ACCCGATAGGTGCCGATCTTATGGGGTTGG|GACCTGGGGTTTCTGCCAAAAATCGACCAT
TACTCAAAGGCCCTCAATATTAGAGACCAG|CTTAAAATAGCCCTCTTAAACGACTGCTAA
ATCCATGCAGATAGAGGCGTACATAAATTC|TGGCGTACTCAAAGGCCCTCAATATTAGTT
TACTCAAAGGCCCTCAATATTAGTGAACCA|GGCAGAATATAAAGCCGCCCAATAATGCTC
ATATTAGTCGTCGACGACCCTTGCTCGGTG|CAGCAGTTTTCAGACGAGGACTGGCGTACT
CCGATGAATTACCTACCAACACTTCTGAAT|GCCGTTTGGAGGGACAGATCGGGGTTCTTG
TCAATATTAGGCTTAGTTCATTGGGTCCGT|CCTCACCCCAACTGGCGTACTCAAAGGCCC
TTTCTGCCAAAAATCGACCATGATGAAGAG|CCTGACTTGTCGCGTACACCTGTATTAAAA
CTTGGGTACTATTCCTCACCCCAACTGGCG|CCACTACCCGCACGGCATCAATCCCACATT
AGTAGGGAGACCGACTGGCGTACTCAAAGG|AAGCCGGTACCATTGTAAGAACGGTATACT
TCCTCACCCCAACTGGCGTACTCAAAGGCC|CGGCATCAATCCCACATTGATAATTTGACT
CTGCGGTAACACACTGGCGTACTCAAAGGC|GGTGCCGATCTTATGGGGTTGGCTCCGGGC
TAACTGATCTTGTTGCTCATTGACCTTGCG|CTCAATATTAGTGAACGCCCCGTCCTTTGA
CGATCTTATGGGGTTGGCTCCGGGCGCAAA|TGCCAAAAATCGACCATGATGAAGAGTAGG
GGCGTACTCAACTGGCGTACTCAAAGGCCC|GGCGTACTCAAAGGCCCTCAATATTAGATT
ACTATTCCTCACCCCAACTGGCGTACTCAA|CCGCACGGCATCAATCCCACATTGATAATT
CCCTGTTTCATCCGCGGACCTGGGGTTTCT|TCGTCAAAACGATCATTACCTAACCCCTGA
GCTCTGCTGCCGTTTGGAGGGACAGATCGG|AATATTAGGTTACGAGCCACTGGCGTACTC
GCCCAATAATGCTCTGCTGCCGTTTGGAGG|AAAGGCCCTCAATATTAGGTTACGAGCCAC
GCAGAGATAGGTATAAAACAAACCCGATAG|AAATGCCCTGTTTCATCCGCGGACCTGGGG
CACTACCCGCACGGCATCAATCCCACATTG|TTGCGATTGAATGAACAACGTCGCGTTGCA
AGGCCCTCAATATTAGATTAGTGGCGTACT|CTTCGCCACTGGCGTACTCAAAGGCCCTCA
TAGAGACCAGACATCCGACTGGCGTACTCA|CGACTGCTAAAGAAGCAATACGACCTTGGG
GCTTTATCGTTGTGCGCACTAATCCATGCA|GTAACGTGGTGCGGATTATACTGGCGTACT
TGCGGTAACTGATCTTGTTGCTCATTGACC|AGGCCCTCAATATTAGTGAACGCCCCGTCC
CTCAAAGGCCCTCAATATTAGGCTTAGTTC|TGGGTACTATTCCTCACCCCAACTGGCGTA
ATCGCATTTAAACTGGCGTACTCAAAGGCC|CCCTGGGAGCATAAATCCCTTAAAATAGCC
TATTAGTGAACCACTTACCGATGAATTACC|CCCAATAATGCTCTGCTGCCGTTTGGAGGG
AACAAACCCGATAGGTGCCGATCTTATGGG|CCGCGGACCTGGGGTTTCTGCCAAAAATCG
TGAACAGCCTGTACTGGCGTACTCAACTGG|AAGGCCCTCAATACTGGCGTACTCAAAGGC
ATCCCACATTGATAATTTGACTAAGTCAGC|GTCGCGTTGCACTTCCCACTCAGCCTGAAC
CAATATTAGCGTTGCAGAGTGCCATACAGA|TAGTTCATTGGGTCCGTCCCAAATGTTTGT
GCGTACTCAAAGGCCCTCAATATTAGATAA|TCAATATTAGAGCTAGTTGGTGGCAAAACC
ATTGGGTCCGTCCCAAATGTTTGTAATGCA|CTCAAAGGCCCTCAATATTAGTCGTCGACG
CAGACGAGGACTGGCGTACTCAAAGGCCCT|TACTGGCGTACTCAACTGGCGTACTCAAAG
AGGTATAAAACAAACCCGATAGGTGCCGAT|TGTTTCATCCGCGGACCTGGGGTTTCTGCC
TGGTGCGGATTATACTGGCGTACTCAAAGG|TTAGCGTTGCAGAGTGCCATACAGAGTGTG
TTGCTGTTAAATGCCCTGTTTCATCCGCGG|CCGCAGAACTACATCGTCAAAACGATCATT
TGGGGTTGGCTCCGGGCGCAAATGTAAAGC|ATCGACCATGATGAAGAGTAGGGAGACCGA
AGCATAAATCCCTTAAAATAGCCCTCTTAA|GGTATGGATATACATTCTTACCTGGTGTAG
TTCCACTACCCGCACGGCATCAATCCCACA|ACCTTGCGATTGAATGAACAACGTCGCGTT
TTAGTCTCTTTGCGGTAACTGATCTTGTTG|CAATATTAGAAGGCCCTCAATATTAGTGAA
GCGTACTCAAAGGCCCTCAATATTAGTCTC|AACTGGCGTACTCAAAGGCCCTCAATATTA
GCACTTCCCACTCAGCCTGAACAGCCTGTA|ACACACTGGCGTACTCAAAGGCCCTCAATA
ATATTAGTTACGGAATTTCCATGAGCGGAC|TATCGCATTTAAACTGGCGTACTCAAAGGC
GGAATTTCCATGAGCGGACTGGCGTACTCA|AACTGGCGTACTCAAAGGCCCTCAATATTA
ACTAAGTCAGCAGTTTTCAGACGAGGACTG|TCAGCCTGAACAGCCTGTACTGGCGTACTC
CTCAAAGGCCCTCAATACTGGCGTACTCAA|GCTCCGGGCGCAAATGTAAAGCTAGTGTAT
TAGGTATAAAACAAACCCGATAGGTGCCGA|CTGTTTCATCCGCGGACCTGGGGTTTCTGC
CCATGCAGATAGAGGCGTACATAAATTCGC|GCGTACTCAAAGGCCCTCAATATTAGTTAC
TTAGTGGCGTACTCAAAGGCCCTCAATATT|TCAAAGGCCCTCAATATTAGATAACTTGCT
GAGCGGACTGGCGTACTCAAAGGCCCTCAA|TCAAAGGCCCTCAATATTAGAGACCAGACA
TGCCCTGGGAGCATAAATCCCTTAAAATAG|TTGCTCGGTGGTATGGATATACATTCTTAC
TGAGCGGACTGGCGTACTCAAAGGCCCTCA|CTCAAAGGCCCTCAATATTAGAGACCAGAC
AACAACGTCGCGTTGCACTTCCCACTCAGC|TGCACCCTGCGGTAACACACTGGCGTACTC
TTCAGACGAGGACTGGCGTACTCAAAGGCC|TGTACTGGCGTACTCAACTGGCGTACTCAA
TCCACTACCCGCACGGCATCAATCCCACAT|CCTTGCGATTGAATGAACAACGTCGCGTTG
GCGTACTCAAAGGCCCTCAATATTAGTTAC|CATACAGAGTGTGTTGCTCTATCGCATTTA
TTTCCATGAGCGGACTGGCGTACTCAAAGG|GGCGTACTCAAAGGCCCTCAATATTAGAGA
ACCACTGGCGTACTCAAAGGCCCTCAATAT|GTCTAGCTACGGCAGAATATAAAGCCGCCC
CAAAGGCCCTCAATACTGGCGTACTCAAAG|TCCGGGCGCAAATGTAAAGCTAGTGTATCT
GGTTACGAGCCACTGGCGTACTCAAAGGCC|CTGGCGTACTCAAAGGCCCTCAATATTAGG
TGCCGATCTTATGGGGTTGGCTCCGGGCGC|TTCTGCCAAAAATCGACCATGATGAAGAGT
GCGGACTGGCGTACTCAAAGGCCCTCAATA|AAAGGCCCTCAATATTAGAGACCAGACATC
AATATTAGTGAACCACTTACCGATGAATTA|CGCCCAATAATGCTCTGCTGCCGTTTGGAG
CGTCCTTTGAATGGTGGGTGCACCCTGCGG|GATAGGTATAAAACAAACCCGATAGGTGCC
TGCGGTAACACACTGGCGTACTCAAAGGCC|GTGCCGATCTTATGGGGTTGGCTCCGGGCG
GCATAAATCCCTTAAAATAGCCCTCTTAAA|GTATGGATATACATTCTTACCTGGTGTAGC
TCGCATTTAAACTGGCGTACTCAAAGGCCC|CCTGGGAGCATAAATCCCTTAAAATAGCCC
CTTACCTGGTGTAGCTATACGAATGCTATC|TTAGTCTCTTTGCGGTAACTGATCTTGTTG
CGCGTTGCACTTCCCACTCAGCCTGAACAG|GCGGTAACACACTGGCGTACTCAAAGGCCC
CCTTGGGTACTATTCCTCACCCCAACTGGC|TCCACTACCCGCACGGCATCAATCCCACAT
GACCAGACATCCGACTGGCGTACTCAAAGG|TGCTAAAGAAGCAATACGACCTTGGGTACT
GGGGTTCTTGGTAACGTGGTGCGGATTATA|TCAAAGGCCCTCAATATTAGCGTTGCAGAG
TATTAGTCTCTTTGCGGTAACTGATCTTGT|CTCAATATTAGAAGGCCCTCAATATTAGTG
CTCAAAGGCCCTCAATATTAGTCTCTTTGC|GCGTACTCAAAGGCCCTCAATATTAGAAGG
CTCTTAAACGACTGCTAAAGAAGCAATACG|GGTGTAGCTATACGAATGCTATCAACGACT
TTTGCGGTAACTGATCTTGTTGCTCATTGA|GAAGGCCCTCAATATTAGTGAACGCCCCGT
CATGAGCGGACTGGCGTACTCAAAGGCCCT|TACTCAAAGGCCCTCAATATTAGAGACCAG
ACTGGCGTACTCAAAGGCCCTCAATATTAG|AAGGCCCTCAATATTAGATTAGTGGCGTAC
TTATGGGGTTGGCTCCGGGCGCAAATGTAA|AAAATCGACCATGATGAAGAGTAGGGAGAC
AAGGCCCTCAATATTAGTCTCTTTGCGGTA|ACTCAAAGGCCCTCAATATTAGAAGGCCCT
TTGCAGAGTGCCATACAGAGTGTGTTGCTC|GTCCGTCCCAAATGTTTGTAATGCATAGGT
GTACTCAAAGGCCCTCAATACTGGCGTACT|TTGGCTCCGGGCGCAAATGTAAAGCTAGTG
GTCCGTCCCAAATGTTTGTAATGCATAGGT|AGGCCCTCAATATTAGTCGTCGACGACCCT
CAAAGGCCCTCAATATTAGAAGGCCCTCAA|TATTAGATTAGTGGCGTACTCAAAGGCCCT
CCTCAATATTAGATAACTTGCTGTTAAATG|AGTTGGTGGCAAAACCCCCGCAGAACTACA
TATAAAGCCGCCCAATAATGCTCTGCTGCC|GGCGTACTCAAAGGCCCTCAATATTAGGTT
CAGCAGTTTTCAGACGAGGACTGGCGTACT|GAACAGCCTGTACTGGCGTACTCAACTGGC
CTACCCGCACGGCATCAATCCCACATTGAT|GCGATTGAATGAACAACGTCGCGTTGCACT
CAATATTAGTGAACCACTTACCGATGAATT|CCGCCCAATAATGCTCTGCTGCCGTTTGGA
CTAATCCATGCAGATAGAGGCGTACATAAA|TACTGGCGTACTCAAAGGCCCTCAATATTA
ATGGATATACATTCTTACCTGGTGTAGCTA|AAGGCCCTCAATATTAGTCTCTTTGCGGTA
GTTTCTGCCAAAAATCGACCATGATGAAGA|CCCTGACTTGTCGCGTACACCTGTATTAAA
TTACCTGGTGTAGCTATACGAATGCTATCA|TAGTCTCTTTGCGGTAACTGATCTTGTTGC
GATCTTGTTGCTCATTGACCTTGCGATTGA|TATTAGTGAACGCCCCGTCCTTTGAATGGT
TTGCGGTAACTGATCTTGTTGCTCATTGAC|AAGGCCCTCAATATTAGTGAACGCCCCGTC
CAAAGGCCCTCAATATTAGTTACGGAATTT|AGTGTGTTGCTCTATCGCATTTAAACTGGC
GAATGCTTTATCGTTGTGCGCACTAATCCA|CTTGGTAACGTGGTGCGGATTATACTGGCG
TCAGCCTGAACAGCCTGTACTGGCGTACTC|TACTCAAAGGCCCTCAATACTGGCGTACTC
TGGCGTACTCAAAGGCCCTCAATATTAGGT|CCTCAATATTAGAGACCAGACATCCGACTG
AATCCCTTAAAATAGCCCTCTTAAACGACT|GATATACATTCTTACCTGGTGTAGCTATAC
TCGTTGTGCGCACTAATCCATGCAGATAGA|TGGTGCGGATTATACTGGCGTACTCAAAGG
AGCAGTTTTCAGACGAGGACTGGCGTACTC|AACAGCCTGTACTGGCGTACTCAACTGGCG
TGAATGGTGGGTGCACCCTGCGGTAACACA|ATAAAACAAACCCGATAGGTGCCGATCTTA
ACTGCTAAAGAAGCAATACGACCTTGGGTA|TACGAATGCTATCAACGACTTTCCACTACC
GTAACTGATCTTGTTGCTCATTGACCTTGC|CCTCAATATTAGTGAACGCCCCGTCCTTTG
ATTACCTACCAACACTTCTGAATGCTTTAT|GGAGGGACAGATCGGGGTTCTTGGTAACGT
TGGCGTACTCAAAGGCCCTCAATATTAGAA|GGCCCTCAATATTAGATTAGTGGCGTACTC
CTGGCGTACTCAAAGGCCCTCAATATTAGT|TGCCATACAGAGTGTGTTGCTCTATCGCAT
AGGCCCTCAATATTAGTGAACCACTTACCG|TATAAAGCCGCCCAATAATGCTCTGCTGCC
GCTAAAGAAGCAATACGACCTTGGGTACTA|GAATGCTATCAACGACTTTCCACTACCCGC
CCTTTGAATGGTGGGTGCACCCTGCGGTAA|AGGTATAAAACAAACCCGATAGGTGCCGAT
CACCCTGCGGTAACACACTGGCGTACTCAA|GATAGGTGCCGATCTTATGGGGTTGGCTCC
AATACGACCTTGGGTACTATTCCTCACCCC|ACGACTTTCCACTACCCGCACGGCATCAAT
ACCAACACTTCTGAATGCTTTATCGTTGTG|CAGATCGGGGTTCTTGGTAACGTGGTGCGG
AGGTGCCGATCTTATGGGGTTGGCTCCGGG|GGTTTCTGCCAAAAATCGACCATGATGAAG
AAACTGGCGTACTCAAAGGCCCTCAATATT|CATAAATCCCTTAAAATAGCCCTCTTAAAC
ATTAGGCTTAGTTCATTGGGTCCGTCCCAA|CCCCAACTGGCGTACTCAAAGGCCCTCAAT
AATGTTTGTAATGCATAGGTGCCCTGGGAG|TATTAGTCGTCGACGACCCTTGCTCGGTGG
TAATTTGACTAAGTCAGCAGTTTTCAGACG|TTCCCACTCAGCCTGAACAGCCTGTACTGG
CTTGCTGTTAAATGCCCTGTTTCATCCGCG|CCCGCAGAACTACATCGTCAAAACGATCAT
CAGTTTTCAGACGAGGACTGGCGTACTCAA|CAGCCTGTACTGGCGTACTCAACTGGCGTA
CGTTGTGCGCACTAATCCATGCAGATAGAG|GGTGCGGATTATACTGGCGTACTCAAAGGC
CTCTTTGCGGTAACTGATCTTGTTGCTCAT|TTAGAAGGCCCTCAATATTAGTGAACGCCC
TCGCAGGGTCTAGCTACGGCAGAATATAAA|TTACGGAATTTCCATGAGCGGACTGGCGTA
GGCGTACTCAAAGGCCCTCAATATTAGAAG|GCCCTCAATATTAGATTAGTGGCGTACTCA
ATGCAGATAGAGGCGTACATAAATTCGCAG|GTACTCAAAGGCCCTCAATATTAGTTACGG
GCCGCCCAATAATGCTCTGCTGCCGTTTGG|CTCAAAGGCCCTCAATATTAGGTTACGAGC
GCCCTGTTTCATCCGCGGACCTGGGGTTTC|ATCGTCAAAACGATCATTACCTAACCCCTG
GGCCCTCAATATTAGGCTTAGTTCATTGGG|CTATTCCTCACCCCAACTGGCGTACTCAAA
TCAAAGGCCCTCAATATTAGATTAGTGGCG|GTATCTTCGCCACTGGCGTACTCAAAGGCC
TCAAAGGCCCTCAATACTGGCGTACTCAAA|CTCCGGGCGCAAATGTAAAGCTAGTGTATC
TGCCGTTTGGAGGGACAGATCGGGGTTCTT|GGTTACGAGCCACTGGCGTACTCAAAGGCC
CAAAGGCCCTCAATATTAGGTTACGAGCCA|TAGAGACCAGACATCCGACTGGCGTACTCA
CTCAAAGGCCCTCAATATTAGAGACCAGAC|TAAAATAGCCCTCTTAAACGACTGCTAAAG
ACCTTGCGATTGAATGAACAACGTCGCGTT|TCCTTTGAATGGTGGGTGCACCCTGCGGTA
CATCAATCCCACATTGATAATTTGACTAAG|ACAACGTCGCGTTGCACTTCCCACTCAGCC
TACGAGCCACTGGCGTACTCAAAGGCCCTC|GCGTACTCAAAGGCCCTCAATATTAGGCTT
AAATGTAAAGCTAGTGTATCTTCGCCACTG|AGGGAGACCGACTGGCGTACTCAAAGGCCC
TAGGTGCCCTGGGAGCATAAATCCCTTAAA|ACCCTTGCTCGGTGGTATGGATATACATTC
AGGCCCTCAATATTAGTCTCTTTGCGGTAA|CTCAAAGGCCCTCAATATTAGAAGGCCCTC
GAAGGCCCTCAATATTAGTGAACGCCCCGT|CTCAAAGGCCCTCAATATTAGGGCAGAGAT
CGGACCTGGGGTTTCTGCCAAAAATCGACC|ATTACCTAACCCCTGACTTGTCGCGTACAC
TGGCGTACTCAAAGGCCCTCAATATTAGCG|AGGCCCTCAATATTAGGCTTAGTTCATTGG
GCAGATAGAGGCGTACATAAATTCGCAGGG|ACTCAAAGGCCCTCAATATTAGTTACGGAA
TATCAACGACTTTCCACTACCCGCACGGCA|GTTGCTCATTGACCTTGCGATTGAATGAAC
TCTGCCAAAAATCGACCATGATGAAGAGTA|TGACTTGTCGCGTACACCTGTATTAAAAGC
AATGCCCTGTTTCATCCGCGGACCTGGGGT|TACATCGTCAAAACGATCATTACCTAACCC
AGGCTTAGTTCATTGGGTCCGTCCCAAATG|CAACTGGCGTACTCAAAGGCCCTCAATATT
TCACCCCAACTGGCGTACTCAAAGGCCCTC|CATCAATCCCACATTGATAATTTGACTAAG
ACTCAAAGGCCCTCAATATTAGGCTTAGTT|TTGGGTACTATTCCTCACCCCAACTGGCGT
TCCCACTCAGCCTGAACAGCCTGTACTGGC|CTGGCGTACTCAAAGGCCCTCAATACTGGC
GATTAGTGGCGTACTCAAAGGCCCTCAATA|ACTCAAAGGCCCTCAATATTAGATAACTTG
GTCAGCAGTTTTCAGACGAGGACTGGCGTA|CTGAACAGCCTGTACTGGCGTACTCAACTG
GAATGAACAACGTCGCGTTGCACTTCCCAC|GTGGGTGCACCCTGCGGTAACACACTGGCG
ATATTAGGCTTAGTTCATTGGGTCCGTCCC|CACCCCAACTGGCGTACTCAAAGGCCCTCA
GACGAGGACTGGCGTACTCAAAGGCCCTCA|CTGGCGTACTCAACTGGCGTACTCAAAGGC
TAATCCATGCAGATAGAGGCGTACATAAAT|ACTGGCGTACTCAAAGGCCCTCAATATTAG
TCAATATTAGTCTCTTTGCGGTAACTGATC|GGCCCTCAATATTAGAAGGCCCTCAATATT
TAGTCGTCGACGACCCTTGCTCGGTGGTAT|AGTTTTCAGACGAGGACTGGCGTACTCAAA
TTGCACTTCCCACTCAGCCTGAACAGCCTG|TAACACACTGGCGTACTCAAAGGCCCTCAA
GCGTACTCAAAGGCCCTCAATATTAGATTA|GCTAGTGTATCTTCGCCACTGGCGTACTCA
GGCGTACTCAAAGGCCCTCAATACTGGCGT|GGGTTGGCTCCGGGCGCAAATGTAAAGCTA
GGACTGGCGTACTCAAAGGCCCTCAATATT|AGGCCCTCAATATTAGAGACCAGACATCCG
TATACATTCTTACCTGGTGTAGCTATACGA|CCTCAATATTAGTCTCTTTGCGGTAACTGA
GTAGGGAGACCGACTGGCGTACTCAAAGGC|AGCCGGTACCATTGTAAGAACGGTATACTT
CCGGGCGCAAATGTAAAGCTAGTGTATCTT|TGAAGAGTAGGGAGACCGACTGGCGTACTC
CTCAATATTAGTGAACCACTTACCGATGAA|AGCCGCCCAATAATGCTCTGCTGCCGTTTG
TATACTGGCGTACTCAAAGGCCCTCAATAT|AGAGTGCCATACAGAGTGTGTTGCTCTATC
TCAAAGGCCCTCAATATTAGGTTACGAGCC|TTAGAGACCAGACATCCGACTGGCGTACTC
TTCGCCACTGGCGTACTCAAAGGCCCTCAA|TCAAAGGCCCTCAATATTAGAGCTAGTTGG
TGGCGTACTCAACTGGCGTACTCAAAGGCC|TGGCGTACTCAAAGGCCCTCAATATTAGAT
GGGCGCAAATGTAAAGCTAGTGTATCTTCG|AAGAGTAGGGAGACCGACTGGCGTACTCAA
TCGCCACTGGCGTACTCAAAGGCCCTCAAT|CAAAGGCCCTCAATATTAGAGCTAGTTGGT
GAATTACCTACCAACACTTCTGAATGCTTT|TTGGAGGGACAGATCGGGGTTCTTGGTAAC
CACTGGCGTACTCAAAGGCCCTCAATACTG|TATGGGGTTGGCTCCGGGCGCAAATGTAAA
CGACGACCCTTGCTCGGTGGTATGGATATA|AGACGAGGACTGGCGTACTCAAAGGCCCTC
CGATTGAATGAACAACGTCGCGTTGCACTT|GAATGGTGGGTGCACCCTGCGGTAACACAC
AACGACTGCTAAAGAAGCAATACGACCTTG|GCTATACGAATGCTATCAACGACTTTCCAC
AATGCTTTATCGTTGTGCGCACTAATCCAT|TTGGTAACGTGGTGCGGATTATACTGGCGT
TACTGGCGTACTCAAAGGCCCTCAATATTA|GTAAAGCTAGTGTATCTTCGCCACTGGCGT
CACCCCAACTGGCGTACTCAAAGGCCCTCA|ATCAATCCCACATTGATAATTTGACTAAGT
TTACGGAATTTCCATGAGCGGACTGGCGTA|TTTAAACTGGCGTACTCAAAGGCCCTCAAT
GGGTGCACCCTGCGGTAACACACTGGCGTA|AACCCGATAGGTGCCGATCTTATGGGGTTG
CGGTGGTATGGATATACATTCTTACCTGGT|GTACTCAAAGGCCCTCAATATTAGTCTCTT
TCTTAAACGACTGCTAAAGAAGCAATACGA|GTGTAGCTATACGAATGCTATCAACGACTT
GGCAGAGATAGGTATAAAACAAACCCGATA|TAAATGCCCTGTTTCATCCGCGGACCTGGG
CAGAGATAGGTATAAAACAAACCCGATAGG|AATGCCCTGTTTCATCCGCGGACCTGGGGT
TTTGAATGGTGGGTGCACCCTGCGGTAACA|GTATAAAACAAACCCGATAGGTGCCGATCT
CCCTCAATATTAGTCGTCGACGACCCTTGC|CTAAGTCAGCAGTTTTCAGACGAGGACTGG
GCGTACTCAAAGGCCCTCAATATTAGGTTA|TCAATATTAGAGACCAGACATCCGACTGGC
CACACTGGCGTACTCAAAGGCCCTCAATAC|CTTATGGGGTTGGCTCCGGGCGCAAATGTA
TACTCAAAGGCCCTCAATATTAGAAGGCCC|TCAATATTAGATTAGTGGCGTACTCAAAGG
CCACTGGCGTACTCAAAGGCCCTCAATATT|TCAAAGGCCCTCAATATTAGGCTTAGTTCA
TATTAGATAACTTGCTGTTAAATGCCCTGT|TGGCAAAACCCCCGCAGAACTACATCGTCA
TACTCAAAGGCCCTCAATATTAGTCGTCGA|GATAATTTGACTAAGTCAGCAGTTTTCAGA
TAATGCTCTGCTGCCGTTTGGAGGGACAGA|CCTCAATATTAGGTTACGAGCCACTGGCGT
CTGATCTTGTTGCTCATTGACCTTGCGATT|AATATTAGTGAACGCCCCGTCCTTTGAATG
GCCTGAACAGCCTGTACTGGCGTACTCAAC|TCAAAGGCCCTCAATACTGGCGTACTCAAA
CCCAACTGGCGTACTCAAAGGCCCTCAATA|AATCCCACATTGATAATTTGACTAAGTCAG
ATATACATTCTTACCTGGTGTAGCTATACG|CCCTCAATATTAGTCTCTTTGCGGTAACTG
CTACGGCAGAATATAAAGCCGCCCAATAAT|ATGAGCGGACTGGCGTACTCAAAGGCCCTC
AATATTAGTGAACGCCCCGTCCTTTGAATG|CTCAATATTAGGGCAGAGATAGGTATAAAA
AATAGCCCTCTTAAACGACTGCTAAAGAAG|CTTACCTGGTGTAGCTATACGAATGCTATC
CCTACCAACACTTCTGAATGCTTTATCGTT|GGACAGATCGGGGTTCTTGGTAACGTGGTG
ACTCAAAGGCCCTCAATATTAGTTACGGAA|CAGAGTGTGTTGCTCTATCGCATTTAAACT
AGGCGTACATAAATTCGCAGGGTCTAGCTA|GCCCTCAATATTAGTTACGGAATTTCCATG
CAACTGGCGTACTCAAAGGCCCTCAATATT|CAAAGGCCCTCAATATTAGATTAGTGGCGT
CCACTGGCGTACTCAAAGGCCCTCAATATT|AGGCCCTCAATATTAGAGCTAGTTGGTGGC
AACTTGCTGTTAAATGCCCTGTTTCATCCG|CCCCCGCAGAACTACATCGTCAAAACGATC
GCGGTAACTGATCTTGTTGCTCATTGACCT|GGCCCTCAATATTAGTGAACGCCCCGTCCT
TCTGAATGCTTTATCGTTGTGCGCACTAAT|GTTCTTGGTAACGTGGTGCGGATTATACTG
GGAGGGACAGATCGGGGTTCTTGGTAACGT|GCCACTGGCGTACTCAAAGGCCCTCAATAT
TTGACCTTGCGATTGAATGAACAACGTCGC|CCGTCCTTTGAATGGTGGGTGCACCCTGCG
GCGTACTCAAAGGCCCTCAATATTAGAGAC|TCCCTTAAAATAGCCCTCTTAAACGACTGC
GAGGACTGGCGTACTCAAAGGCCCTCAATA|GCGTACTCAACTGGCGTACTCAAAGGCCCT
CACTTCCCACTCAGCCTGAACAGCCTGTAC|CACACTGGCGTACTCAAAGGCCCTCAATAC
GCGTACTCAAAGGCCCTCAATATTAGCGTT|GCCCTCAATATTAGGCTTAGTTCATTGGGT
TCAAAGGCCCTCAATATTAGGGCAGAGATA|AATATTAGATAACTTGCTGTTAAATGCCCT
CGTACTCAAAGGCCCTCAATATTAGGTTAC|CAATATTAGAGACCAGACATCCGACTGGCG
ATACAGAGTGTGTTGCTCTATCGCATTTAA|TGTTTGTAATGCATAGGTGCCCTGGGAGCA
TGGAGGGACAGATCGGGGTTCTTGGTAACG|AGCCACTGGCGTACTCAAAGGCCCTCAATA
AGAATATAAAGCCGCCCAATAATGCTCTGC|GACTGGCGTACTCAAAGGCCCTCAATATTA
CTCAATATTAGGGCAGAGATAGGTATAAAA|TAACTTGCTGTTAAATGCCCTGTTTCATCC
CAATATTAGATAACTTGCTGTTAAATGCCC|TGGTGGCAAAACCCCCGCAGAACTACATCG
GGATTATACTGGCGTACTCAAAGGCCCTCA|TTGCAGAGTGCCATACAGAGTGTGTTGCTC
GGCGTACTCAAAGGCCCTCAATATTAGATA|CTCAATATTAGAGCTAGTTGGTGGCAAAAC
TACTCAAAGGCCCTCAATATTAGATTAGTG|AGTGTATCTTCGCCACTGGCGTACTCAAAG
TCAAAGGCCCTCAATATTAGTGAACCACTT|AGAATATAAAGCCGCCCAATAATGCTCTGC
AACGACTTTCCACTACCCGCACGGCATCAA|CTCATTGACCTTGCGATTGAATGAACAACG
CCTCAATATTAGTCTCTTTGCGGTAACTGA|AAGGCCCTCAATATTAGAAGGCCCTCAATA
CTCTATCGCATTTAAACTGGCGTACTCAAA|GGTGCCCTGGGAGCATAAATCCCTTAAAAT
CAAAGGCCCTCAATATTAGTCGTCGACGAC|ATTTGACTAAGTCAGCAGTTTTCAGACGAG
AGTTACGGAATTTCCATGAGCGGACTGGCG|CATTTAAACTGGCGTACTCAAAGGCCCTCA
CCCTCAATATTAGTCTCTTTGCGGTAACTG|AAAGGCCCTCAATATTAGAAGGCCCTCAAT
CGACTGGCGTACTCAAAGGCCCTCAATATT|CAATACGACCTTGGGTACTATTCCTCACCC
GTGGTGCGGATTATACTGGCGTACTCAAAG|ATTAGCGTTGCAGAGTGCCATACAGAGTGT
AGCTACGGCAGAATATAAAGCCGCCCAATA|CCATGAGCGGACTGGCGTACTCAAAGGCCC
CGGAATTTCCATGAGCGGACTGGCGTACTC|AAACTGGCGTACTCAAAGGCCCTCAATATT
TTCGCAGGGTCTAGCTACGGCAGAATATAA|GTTACGGAATTTCCATGAGCGGACTGGCGT
CTGGCGTACTCAAAGGCCCTCAATATTAGA|AAAGCTAGTGTATCTTCGCCACTGGCGTAC
CGTACATAAATTCGCAGGGTCTAGCTACGG|CTCAATATTAGTTACGGAATTTCCATGAGC
ACTTTCCACTACCCGCACGGCATCAATCCC|TTGACCTTGCGATTGAATGAACAACGTCGC
AGTTCATTGGGTCCGTCCCAAATGTTTGTA|GCGTACTCAAAGGCCCTCAATATTAGTCGT
GCGGTAACACACTGGCGTACTCAAAGGCCC|TGCCGATCTTATGGGGTTGGCTCCGGGCGC
TGACCTTGCGATTGAATGAACAACGTCGCG|CGTCCTTTGAATGGTGGGTGCACCCTGCGG
TTTATCGTTGTGCGCACTAATCCATGCAGA|AACGTGGTGCGGATTATACTGGCGTACTCA
TTGATAATTTGACTAAGTCAGCAGTTTTCA|GCACTTCCCACTCAGCCTGAACAGCCTGTA
CAATATTAGGGCAGAGATAGGTATAAAACA|ACTTGCTGTTAAATGCCCTGTTTCATCCGC
TATTAGTGAACGCCCCGTCCTTTGAATGGT|CAATATTAGGGCAGAGATAGGTATAAAACA
TCAAAGGCCCTCAATATTAGCGTTGCAGAG|AATATTAGGCTTAGTTCATTGGGTCCGTCC
TGGTAACGTGGTGCGGATTATACTGGCGTA|CCTCAATATTAGCGTTGCAGAGTGCCATAC
GGCGTACTCAAAGGCCCTCAATATTAGTCG|CATTGATAATTTGACTAAGTCAGCAGTTTT
AATATTAGTCTCTTTGCGGTAACTGATCTT|CCCTCAATATTAGAAGGCCCTCAATATTAG
AGGTGCCCTGGGAGCATAAATCCCTTAAAA|CCCTTGCTCGGTGGTATGGATATACATTCT
GGGTCCGTCCCAAATGTTTGTAATGCATAG|AAAGGCCCTCAATATTAGTCGTCGACGACC
ACGACCCTTGCTCGGTGGTATGGATATACA|ACGAGGACTGGCGTACTCAAAGGCCCTCAA
GCGCAAATGTAAAGCTAGTGTATCTTCGCC|GAGTAGGGAGACCGACTGGCGTACTCAAAG
CCAACACTTCTGAATGCTTTATCGTTGTGC|AGATCGGGGTTCTTGGTAACGTGGTGCGGA
ACTTACCGATGAATTACCTACCAACACTTC|CTGCTGCCGTTTGGAGGGACAGATCGGGGT
AGGGTCTAGCTACGGCAGAATATAAAGCCG|GGAATTTCCATGAGCGGACTGGCGTACTCA
ATATAAAGCCGCCCAATAATGCTCTGCTGC|TGGCGTACTCAAAGGCCCTCAATATTAGGT
CACTAATCCATGCAGATAGAGGCGTACATA|TATACTGGCGTACTCAAAGGCCCTCAATAT
GTGCACCCTGCGGTAACACACTGGCGTACT|CCCGATAGGTGCCGATCTTATGGGGTTGGC
TGGCGTACTCAAAGGCCCTCAATATTAGAT|AAGCTAGTGTATCTTCGCCACTGGCGTACT
TCAACGACTTTCCACTACCCGCACGGCATC|TGCTCATTGACCTTGCGATTGAATGAACAA
CGGGGTTCTTGGTAACGTGGTGCGGATTAT|CTCAAAGGCCCTCAATATTAGCGTTGCAGA
TACTGGCGTACTCAACTGGCGTACTCAAAG|TACTGGCGTACTCAAAGGCCCTCAATATTA
GCCCTCAATATTAGTTACGGAATTTCCATG|GTTGCTCTATCGCATTTAAACTGGCGTACT
AACCCGATAGGTGCCGATCTTATGGGGTTG|GGACCTGGGGTTTCTGCCAAAAATCGACCA
AGCCGCCCAATAATGCTCTGCTGCCGTTTG|ACTCAAAGGCCCTCAATATTAGGTTACGAG
AACGCCCCGTCCTTTGAATGGTGGGTGCAC|GGGCAGAGATAGGTATAAAACAAACCCGAT
AGGCCCTCAATATTAGAGACCAGACATCCG|TAGCCCTCTTAAACGACTGCTAAAGAAGCA
CAAACCCGATAGGTGCCGATCTTATGGGGT|GCGGACCTGGGGTTTCTGCCAAAAATCGAC
AGTGCCATACAGAGTGTGTTGCTCTATCGC|CCCAAATGTTTGTAATGCATAGGTGCCCTG
TGGCGTACTCAAAGGCCCTCAATATTAGTC|ACATTGATAATTTGACTAAGTCAGCAGTTT
TATTAGATTAGTGGCGTACTCAAAGGCCCT|GGCGTACTCAAAGGCCCTCAATATTAGATA
ACGACTTTCCACTACCCGCACGGCATCAAT|TCATTGACCTTGCGATTGAATGAACAACGT
ACTCAACTGGCGTACTCAAAGGCCCTCAAT|ACTCAAAGGCCCTCAATATTAGATTAGTGG
TTGTGCGCACTAATCCATGCAGATAGAGGC|TGCGGATTATACTGGCGTACTCAAAGGCCC
ACCATGATGAAGAGTAGGGAGACCGACTGG|CACCTGTATTAAAAGCCGGTACCATTGTAA
CAAAGGCCCTCAATATTAGATAACTTGCTG|TAGAGCTAGTTGGTGGCAAAACCCCCGCAG
CCAACTGGCGTACTCAAAGGCCCTCAATAT|ATCCCACATTGATAATTTGACTAAGTCAGC
ACACTGGCGTACTCAAAGGCCCTCAATACT|TTATGGGGTTGGCTCCGGGCGCAAATGTAA
AAGGCCCTCAATATTAGAAGGCCCTCAATA|TTAGATTAGTGGCGTACTCAAAGGCCCTCA
GTGGCGTACTCAAAGGCCCTCAATATTAGG|AAGGCCCTCAATATTAGATAACTTGCTGTT
TATTAGAGACCAGACATCCGACTGGCGTAC|AAACGACTGCTAAAGAAGCAATACGACCTT
CTTCCCACTCAGCCTGAACAGCCTGTACTG|CACTGGCGTACTCAAAGGCCCTCAATACTG
CAATATTAGGTTACGAGCCACTGGCGTACT|ACATCCGACTGGCGTACTCAAAGGCCCTCA
CATAGGTGCCCTGGGAGCATAAATCCCTTA|CGACCCTTGCTCGGTGGTATGGATATACAT
TTGCGATTGAATGAACAACGTCGCGTTGCA|TTTGAATGGTGGGTGCACCCTGCGGTAACA
GCGGACCTGGGGTTTCTGCCAAAAATCGAC|CATTACCTAACCCCTGACTTGTCGCGTACA
GTACTCAAAGGCCCTCAATATTAGAGACCA|CCTTAAAATAGCCCTCTTAAACGACTGCTA
CGTTGCAGAGTGCCATACAGAGTGTGTTGC|GGGTCCGTCCCAAATGTTTGTAATGCATAG
AGCAATACGACCTTGGGTACTATTCCTCAC|TCAACGACTTTCCACTACCCGCACGGCATC
AACTGGCGTACTCAAAGGCCCTCAATATTA|AAAGGCCCTCAATATTAGATTAGTGGCGTA
AAGGCCCTCAATATTAGAGACCAGACATCC|ATAGCCCTCTTAAACGACTGCTAAAGAAGC
AATATTAGGTTACGAGCCACTGGCGTACTC|CATCCGACTGGCGTACTCAAAGGCCCTCAA
ACCCGCACGGCATCAATCCCACATTGATAA|GATTGAATGAACAACGTCGCGTTGCACTTC
GGTTTCTGCCAAAAATCGACCATGATGAAG|CCCCTGACTTGTCGCGTACACCTGTATTAA
GCTACGGCAGAATATAAAGCCGCCCAATAA|CATGAGCGGACTGGCGTACTCAAAGGCCCT
GCGTACTCAACTGGCGTACTCAAAGGCCCT|GCGTACTCAAAGGCCCTCAATATTAGATTA
TAAAGAAGCAATACGACCTTGGGTACTATT|ATGCTATCAACGACTTTCCACTACCCGCAC
CTACCAACACTTCTGAATGCTTTATCGTTG|GACAGATCGGGGTTCTTGGTAACGTGGTGC
ATAGGTGCCGATCTTATGGGGTTGGCTCCG|GGGGTTTCTGCCAAAAATCGACCATGATGA
TGCGGATTATACTGGCGTACTCAAAGGCCC|GCGTTGCAGAGTGCCATACAGAGTGTGTTG
GCACTAATCCATGCAGATAGAGGCGTACAT|TTATACTGGCGTACTCAAAGGCCCTCAATA
AAGAGTAGGGAGACCGACTGGCGTACTCAA|TAAAAGCCGGTACCATTGTAAGAACGGTAT
CGTACTCAAAGGCCCTCAATATTAGAAGGC|CCTCAATATTAGATTAGTGGCGTACTCAAA
CCCTCAATATTAGGCTTAGTTCATTGGGTC|ATTCCTCACCCCAACTGGCGTACTCAAAGG
GGCATCAATCCCACATTGATAATTTGACTA|GAACAACGTCGCGTTGCACTTCCCACTCAG
TTACGAGCCACTGGCGTACTCAAAGGCCCT|GGCGTACTCAAAGGCCCTCAATATTAGGCT
AACACACTGGCGTACTCAAAGGCCCTCAAT|ATCTTATGGGGTTGGCTCCGGGCGCAAATG
TCCGCGGACCTGGGGTTTCTGCCAAAAATC|GATCATTACCTAACCCCTGACTTGTCGCGT
TGAACCACTTACCGATGAATTACCTACCAA|AATGCTCTGCTGCCGTTTGGAGGGACAGAT
TATTAGGTTACGAGCCACTGGCGTACTCAA|TCCGACTGGCGTACTCAAAGGCCCTCAATA
AGAGATAGGTATAAAACAAACCCGATAGGT|ATGCCCTGTTTCATCCGCGGACCTGGGGTT
TAGGGAGACCGACTGGCGTACTCAAAGGCC|GCCGGTACCATTGTAAGAACGGTATACTTG
TTAGATTAGTGGCGTACTCAAAGGCCCTCA|CGTACTCAAAGGCCCTCAATATTAGATAAC
ACACTTCTGAATGCTTTATCGTTGTGCGCA|TCGGGGTTCTTGGTAACGTGGTGCGGATTA
TTGGGTACTATTCCTCACCCCAACTGGCGT|CACTACCCGCACGGCATCAATCCCACATTG
CTCAACTGGCGTACTCAAAGGCCCTCAATA|CTCAAAGGCCCTCAATATTAGATTAGTGGC
CCTCAATATTAGTGAACCACTTACCGATGA|AAGCCGCCCAATAATGCTCTGCTGCCGTTT
GCGGATTATACTGGCGTACTCAAAGGCCCT|CGTTGCAGAGTGCCATACAGAGTGTGTTGC
ATATTAGTCTCTTTGCGGTAACTGATCTTG|CCTCAATATTAGAAGGCCCTCAATATTAGT
GTGAACCACTTACCGATGAATTACCTACCA|TAATGCTCTGCTGCCGTTTGGAGGGACAGA
TGGCGTACTCAAAGGCCCTCAATATTAGAT|CCTCAATATTAGAGCTAGTTGGTGGCAAAA
ACTTGCTGTTAAATGCCCTGTTTCATCCGC|CCCCGCAGAACTACATCGTCAAAACGATCA
GCCACTGGCGTACTCAAAGGCCCTCAATAT|CTCAAAGGCCCTCAATATTAGGCTTAGTTC
TGCTGTTAAATGCCCTGTTTCATCCGCGGA|CGCAGAACTACATCGTCAAAACGATCATTA
AAATCCCTTAAAATAGCCCTCTTAAACGAC|GGATATACATTCTTACCTGGTGTAGCTATA
GCCCTCAATATTAGCGTTGCAGAGTGCCAT|AGGCTTAGTTCATTGGGTCCGTCCCAAATG
ACATCCGACTGGCGTACTCAAAGGCCCTCA|AGAAGCAATACGACCTTGGGTACTATTCCT
TAAATGCCCTGTTTCATCCGCGGACCTGGG|ACTACATCGTCAAAACGATCATTACCTAAC
ACTTCCCACTCAGCCTGAACAGCCTGTACT|ACACTGGCGTACTCAAAGGCCCTCAATACT
TTCCCACTCAGCCTGAACAGCCTGTACTGG|ACTGGCGTACTCAAAGGCCCTCAATACTGG
CAGCCTGTACTGGCGTACTCAACTGGCGTA|CCCTCAATACTGGCGTACTCAAAGGCCCTC
TCCCACATTGATAATTTGACTAAGTCAGCA|TCGCGTTGCACTTCCCACTCAGCCTGAACA
AAAGGCCCTCAATATTAGGTTACGAGCCAC|AGAGACCAGACATCCGACTGGCGTACTCAA
CTTCTGAATGCTTTATCGTTGTGCGCACTA|GGGTTCTTGGTAACGTGGTGCGGATTATAC
TAGTTACGGAATTTCCATGAGCGGACTGGC|GCATTTAAACTGGCGTACTCAAAGGCCCTC
CAATATTAGAGACCAGACATCCGACTGGCG|CTTAAACGACTGCTAAAGAAGCAATACGAC
CCTGGGGTTTCTGCCAAAAATCGACCATGA|CCTAACCCCTGACTTGTCGCGTACACCTGT
GTCGCGTTGCACTTCCCACTCAGCCTGAAC|CTGCGGTAACACACTGGCGTACTCAAAGGC
ATTGACCTTGCGATTGAATGAACAACGTCG|CCCGTCCTTTGAATGGTGGGTGCACCCTGC
AAGGCCCTCAATATTAGGGCAGAGATAGGT|ATTAGATAACTTGCTGTTAAATGCCCTGTT
GCCCTCAATATTAGTCTCTTTGCGGTAACT|CAAAGGCCCTCAATATTAGAAGGCCCTCAA
AATCGACCATGATGAAGAGTAGGGAGACCG|GCGTACACCTGTATTAAAAGCCGGTACCAT
AATTTCCATGAGCGGACTGGCGTACTCAAA|CTGGCGTACTCAAAGGCCCTCAATATTAGA
GGCCCTCAATATTAGTTACGGAATTTCCAT|TGTTGCTCTATCGCATTTAAACTGGCGTAC
CTTTATCGTTGTGCGCACTAATCCATGCAG|TAACGTGGTGCGGATTATACTGGCGTACTC
TTTCAGACGAGGACTGGCGTACTCAAAGGC|CTGTACTGGCGTACTCAACTGGCGTACTCA
GTTTGGAGGGACAGATCGGGGTTCTTGGTA|ACGAGCCACTGGCGTACTCAAAGGCCCTCA
TTGTTGCTCATTGACCTTGCGATTGAATGA|AGTGAACGCCCCGTCCTTTGAATGGTGGGT
TAGAGGCGTACATAAATTCGCAGGGTCTAG|AAGGCCCTCAATATTAGTTACGGAATTTCC
TATCGCATTTAAACTGGCGTACTCAAAGGC|GCCCTGGGAGCATAAATCCCTTAAAATAGC
AACCACTGGCGTACTCAAAGGCCCTCAATA|GGTCTAGCTACGGCAGAATATAAAGCCGCC
TGACTAAGTCAGCAGTTTTCAGACGAGGAC|ACTCAGCCTGAACAGCCTGTACTGGCGTAC
TACTCAAAGGCCCTCAATATTAGGGCAGAG|CTCAATATTAGATAACTTGCTGTTAAATGC
AAAGGCCCTCAATATTAGATTAGTGGCGTA|ATCTTCGCCACTGGCGTACTCAAAGGCCCT
ATCTTATGGGGTTGGCTCCGGGCGCAAATG|CCAAAAATCGACCATGATGAAGAGTAGGGA
ACCTACCAACACTTCTGAATGCTTTATCGT|GGGACAGATCGGGGTTCTTGGTAACGTGGT
GTACTCAAAGGCCCTCAATATTAGTGAACC|CGGCAGAATATAAAGCCGCCCAATAATGCT
TCAATATTAGAAGGCCCTCAATATTAGTGA|AGTGGCGTACTCAAAGGCCCTCAATATTAG
CTCAAAGGCCCTCAATATTAGAAGGCCCTC|AATATTAGATTAGTGGCGTACTCAAAGGCC
GCAGTTTTCAGACGAGGACTGGCGTACTCA|ACAGCCTGTACTGGCGTACTCAACTGGCGT
CTGGCGTACTCAAAGGCCCTCAATATTAGA|AGGCCCTCAATATTAGATTAGTGGCGTACT
CCAATAATGCTCTGCTGCCGTTTGGAGGGA|AGGCCCTCAATATTAGGTTACGAGCCACTG
AAAGCTAGTGTATCTTCGCCACTGGCGTAC|ACCGACTGGCGTACTCAAAGGCCCTCAATA
AGCCTGAACAGCCTGTACTGGCGTACTCAA|CTCAAAGGCCCTCAATACTGGCGTACTCAA
CTTGGTAACGTGGTGCGGATTATACTGGCG|GCCCTCAATATTAGCGTTGCAGAGTGCCAT
CCAGACATCCGACTGGCGTACTCAAAGGCC|CTAAAGAAGCAATACGACCTTGGGTACTAT
GTTTCATCCGCGGACCTGGGGTTTCTGCCA|CAAAACGATCATTACCTAACCCCTGACTTG
GTTGCACTTCCCACTCAGCCTGAACAGCCT|GTAACACACTGGCGTACTCAAAGGCCCTCA
TAGAAGGCCCTCAATATTAGTGAACGCCCC|TACTCAAAGGCCCTCAATATTAGGGCAGAG
ACCACTTACCGATGAATTACCTACCAACAC|GCTCTGCTGCCGTTTGGAGGGACAGATCGG
CTGGCGTACTCAAAGGCCCTCAATACTGGC|TGGGGTTGGCTCCGGGCGCAAATGTAAAGC
ATAATGCTCTGCTGCCGTTTGGAGGGACAG|CCCTCAATATTAGGTTACGAGCCACTGGCG
GCTCCGGGCGCAAATGTAAAGCTAGTGTAT|TGATGAAGAGTAGGGAGACCGACTGGCGTA
TCAACTGGCGTACTCAAAGGCCCTCAATAT|TCAAAGGCCCTCAATATTAGATTAGTGGCG
TTTTCAGACGAGGACTGGCGTACTCAAAGG|CCTGTACTGGCGTACTCAACTGGCGTACTC
GAGTGCCATACAGAGTGTGTTGCTCTATCG|TCCCAAATGTTTGTAATGCATAGGTGCCCT
CTTGCGATTGAATGAACAACGTCGCGTTGC|CTTTGAATGGTGGGTGCACCCTGCGGTAAC
CAAATGTAAAGCTAGTGTATCTTCGCCACT|TAGGGAGACCGACTGGCGTACTCAAAGGCC
CCCGATAGGTGCCGATCTTATGGGGTTGGC|ACCTGGGGTTTCTGCCAAAAATCGACCATG
TACATTCTTACCTGGTGTAGCTATACGAAT|TCAATATTAGTCTCTTTGCGGTAACTGATC
ACTCAAAGGCCCTCAATATTAGTCGTCGAC|ATAATTTGACTAAGTCAGCAGTTTTCAGAC
ACTCAAAGGCCCTCAATATTAGAGACCAGA|TTAAAATAGCCCTCTTAAACGACTGCTAAA
TTAGAGACCAGACATCCGACTGGCGTACTC|ACGACTGCTAAAGAAGCAATACGACCTTGG
TAACTTGCTGTTAAATGCCCTGTTTCATCC|ACCCCCGCAGAACTACATCGTCAAAACGAT
GGGAGACCGACTGGCGTACTCAAAGGCCCT|CGGTACCATTGTAAGAACGGTATACTTGTA
CAATATTAGTCTCTTTGCGGTAACTGATCT|GCCCTCAATATTAGAAGGCCCTCAATATTA
TGGGTCCGTCCCAAATGTTTGTAATGCATA|CAAAGGCCCTCAATATTAGTCGTCGACGAC
ACCCCAACTGGCGTACTCAAAGGCCCTCAA|TCAATCCCACATTGATAATTTGACTAAGTC
GAGATAGGTATAAAACAAACCCGATAGGTG|TGCCCTGTTTCATCCGCGGACCTGGGGTTT
ATTATACTGGCGTACTCAAAGGCCCTCAAT|GCAGAGTGCCATACAGAGTGTGTTGCTCTA
GACGACCCTTGCTCGGTGGTATGGATATAC|GACGAGGACTGGCGTACTCAAAGGCCCTCA
AAAGGCCCTCAATATTAGGGCAGAGATAGG|TATTAGATAACTTGCTGTTAAATGCCCTGT
AAGCTAGTGTATCTTCGCCACTGGCGTACT|CCGACTGGCGTACTCAAAGGCCCTCAATAT
TACTCAAAGGCCCTCAATATTAGATAACTT|ATATTAGAGCTAGTTGGTGGCAAAACCCCC
GCTCATTGACCTTGCGATTGAATGAACAAC|ACGCCCCGTCCTTTGAATGGTGGGTGCACC
CGGCAGAATATAAAGCCGCCCAATAATGCT|AGCGGACTGGCGTACTCAAAGGCCCTCAAT
AAACGACTGCTAAAGAAGCAATACGACCTT|AGCTATACGAATGCTATCAACGACTTTCCA
CTGAATGCTTTATCGTTGTGCGCACTAATC|TTCTTGGTAACGTGGTGCGGATTATACTGG
TCGACCATGATGAAGAGTAGGGAGACCGAC|GTACACCTGTATTAAAAGCCGGTACCATTG
GGTGGGTGCACCCTGCGGTAACACACTGGC|ACAAACCCGATAGGTGCCGATCTTATGGGG
CAGATCGGGGTTCTTGGTAACGTGGTGCGG|GCGTACTCAAAGGCCCTCAATATTAGCGTT
ACGTCGCGTTGCACTTCCCACTCAGCCTGA|CCCTGCGGTAACACACTGGCGTACTCAAAG
TAGGTTACGAGCCACTGGCGTACTCAAAGG|GACTGGCGTACTCAAAGGCCCTCAATATTA
CCCTCTTAAACGACTGCTAAAGAAGCAATA|CTGGTGTAGCTATACGAATGCTATCAACGA
TGGCTCCGGGCGCAAATGTAAAGCTAGTGT|CATGATGAAGAGTAGGGAGACCGACTGGCG
ATATTAGATAACTTGCTGTTAAATGCCCTG|GTGGCAAAACCCCCGCAGAACTACATCGTC
CTGGGAGCATAAATCCCTTAAAATAGCCCT|TCGGTGGTATGGATATACATTCTTACCTGG
GCCATACAGAGTGTGTTGCTCTATCGCATT|AAATGTTTGTAATGCATAGGTGCCCTGGGA
GTACTCAAAGGCCCTCAATATTAGTCTCTT|CTGGCGTACTCAAAGGCCCTCAATATTAGA
ATGAACAACGTCGCGTTGCACTTCCCACTC|GGGTGCACCCTGCGGTAACACACTGGCGTA
ATGTAAAGCTAGTGTATCTTCGCCACTGGC|GGAGACCGACTGGCGTACTCAAAGGCCCTC
GTGGGTGCACCCTGCGGTAACACACTGGCG|CAAACCCGATAGGTGCCGATCTTATGGGGT
CCCTCAATATTAGATAACTTGCTGTTAAAT|TAGTTGGTGGCAAAACCCCCGCAGAACTAC
